revised_movement_label,segBoundary_start,segBoundary_end,frame_length,average_speed,average_back_height
sniffing,0,50,50,50.732408648873786,28.10410814016531
left_turning,51,100,49,77.57057646824555,27.776202251911087
sniffing,101,600,499,32.01751929853067,30.775629355621525
pausing,601,1051,450,15.950156747251768,32.78037829161074
sniffing,1052,1195,143,19.176636768051043,32.4101715295105
grooming,1196,1270,74,22.29335215491151,27.785228361601476
rising,1271,1305,34,33.53523255809109,32.52216232001543
sniffing,1306,1385,79,23.957674201860243,29.028319891457205
climbing,1386,1410,24,56.26431051686034,33.245078626240954
right_turning,1411,1425,14,135.4243748205219,27.66273838534473
walking,1426,1524,98,120.38997100173678,25.91307569763766
sniffing,1525,1566,41,37.89306100715674,25.886226603965167
walking,1567,1742,175,113.2475223802352,27.655324801176178
left_turning,1743,1777,34,114.78832497426438,29.270387900119424
sniffing,1778,1807,29,39.36901002398385,32.098625551539655
rising,1808,1822,14,79.07538535884,32.87909152094829
walking,1823,1843,20,182.0549618363079,29.212998921238967
sniffing,1844,1928,84,44.76018931094523,26.57869323133514
rising,1929,1968,39,32.53934049231381,28.658778253278445
sniffing,1969,1973,4,98.07939942898973,30.673610633810757
left_turning,1974,1978,4,116.24272778337965,29.386674768301646
sniffing,1979,1988,9,100.61862306177878,31.287202531266075
rising,1989,2003,14,56.42232786609559,33.94175650727586
left_turning,2004,2128,124,85.14428627092693,28.748908298412307
sniffing,2129,2174,45,75.80056606182113,28.98765310679604
trotting,2175,2196,21,219.50088135684692,28.963274187746574
walking,2197,2231,34,158.83218132214023,26.752437450343525
sniffing,2232,2264,32,45.04078261977555,27.53486978621405
rising,2265,2294,29,55.81592153224544,33.52523369913208
left_turning,2295,2299,4,112.498609562177,29.822640304899522
walking,2300,2324,24,124.56722895340688,30.6514842604748
sniffing,2325,2368,43,81.62658628326581,28.361247160056738
right_turning,2369,2415,46,79.49914850638868,30.990219525094716
sniffing,2416,2486,70,89.21260675786382,30.48461669833054
stepping,2487,2542,55,55.71898454217977,33.02110284631272
walking,2543,2624,81,145.13293425581952,31.109652962857687
sniffing,2625,2669,44,97.55045344887832,31.152578287769675
rising,2670,2689,19,50.64314848511901,32.1483041161496
sniffing,2690,2704,14,24.165707905141236,30.3757241692658
rising,2705,2739,34,40.25050987518844,34.89602549385064
sniffing,2740,2799,59,40.24084272804145,35.383725538130925
walking,2800,2831,31,152.9984335296825,33.30024843662645
trotting,2832,2859,27,221.70689529650446,28.994556016506642
sniffing,2860,2884,24,58.26712193721619,28.998334980296555
rising,2885,2974,89,34.967461438710316,32.806154918862646
walking,2975,2979,4,137.41398314881135,30.521430298242194
left_turning,2980,3010,30,78.09963466366814,29.28421499025993
sniffing,3011,3025,14,23.221092114735217,30.854629077827592
hunching,3026,3085,59,43.32676876408856,35.0916908172769
rising,3086,3100,14,54.830287236168566,34.736188450122214
walking,3101,3151,50,185.08197949648965,29.638457298170025
sniffing,3152,3190,38,49.193404404742836,25.100612668955147
rising,3191,3210,19,24.32334513011366,30.382172435231762
sniffing,3211,3255,44,27.521777108128735,27.802699376031427
rising,3256,3265,9,18.14804539735116,32.711952372849424
rearing,3266,3275,9,27.36005553966902,36.85370868979788
climbing,3276,3305,29,45.44043861444787,47.027686097958245
sniffing,3306,3340,34,64.35241082741905,31.179727556173418
left_turning,3341,3345,4,102.43710708983569,34.850511210795126
sniffing,3346,3415,69,28.774200129358242,32.40454875814144
stepping,3416,3442,26,103.81189965389524,32.54151383572579
walking,3443,3483,40,172.62308422456667,31.2398769175279
sniffing,3484,3498,14,42.806341322133754,29.28248107320776
walking,3499,3527,28,136.7230758806046,28.36399382768262
sniffing,3528,3564,36,65.07002611719011,26.953874498464906
left_turning,3565,3569,4,100.52298012404377,26.54773261768367
sniffing,3570,3629,59,32.88487018016863,25.724852896167555
rising,3630,3639,9,40.388894925853286,34.118615944769886
rearing,3640,3664,24,37.030575001342655,34.42495506143901
sniffing,3665,3894,229,32.426563017478884,31.564734615083232
rising,3895,3904,9,40.85636651559602,32.86062800454449
sniffing,3905,3994,89,15.129473077661254,33.555859447382765
rising,3995,4184,189,17.51687436415018,35.89446369714705
sniffing,4185,4346,161,37.05190614489933,31.70230342616141
rising,4347,4361,14,82.88005824059034,31.811856413228668
left_turning,4362,4407,45,108.82318362176557,27.21264468027727
sniffing,4408,4442,34,31.14910505785714,28.907672492092967
rising,4443,4477,34,25.206539319920743,33.884177184581894
right_turning,4478,4486,8,222.00173055753115,30.845527352293864
walking,4487,4519,32,217.61144015950623,27.482463569622116
trotting,4520,4535,15,203.51977475203927,29.150762933403847
sniffing,4536,4555,19,31.940335775036413,25.65974536826393
stepping,4556,4652,96,77.46457828275489,31.03045653569642
walking,4653,4679,26,143.98399248334658,28.93836492521654
sniffing,4680,4726,46,70.10026191184656,26.31371726491091
left_turning,4727,4781,54,119.84744279867111,28.113973562945585
walking,4782,4804,22,169.4330339970053,30.541734561760073
sniffing,4805,4864,59,33.41826846537112,27.901830744091555
rising,4865,4879,14,56.79020934150852,31.217027994344694
left_turning,4880,4893,13,177.95720377316155,32.865618844102976
trotting,4894,4914,20,238.95844490640343,30.59198931133552
rising,4915,4984,69,44.154019591671954,27.01466769633496
climbing,4985,5034,49,40.764087081542144,53.08952587845423
rising,5035,5064,29,26.96581888594919,33.56531630845064
right_turning,5065,5074,9,150.13537953795736,30.691556978833184
walking,5075,5079,4,150.85187447116024,34.25906851152279
left_turning,5080,5084,4,113.62674720200967,37.674488275450884
walking,5085,5094,9,56.56691520034635,41.84428781071798
climbing,5095,5144,49,38.06790756963054,49.44488505218641
sniffing,5145,5159,14,79.65473652088632,35.14177600191849
trotting,5160,5168,8,194.5119078865957,31.92518059256036
walking,5169,5181,12,146.1787324177651,30.544405898988884
rising,5182,5206,24,40.76582532554955,36.03998156171382
left_turning,5207,5211,4,87.5972459172437,33.47006547668816
sniffing,5212,5251,39,37.287494183963034,33.599590001954724
left_turning,5252,5306,54,65.59261057184095,31.486111198093237
stepping,5307,5329,22,70.16021179083793,32.157625164404045
walking,5330,5352,22,187.57464630907018,28.055377885090177
sniffing,5353,5377,24,57.14779280815827,27.449717332548673
walking,5378,5411,33,108.4639449317684,30.539173887958523
sniffing,5412,5421,9,48.297225623104744,32.91772721797581
left_turning,5422,5441,19,58.32862367615638,30.052677761825084
sniffing,5442,5606,164,18.550147035747173,26.675079065686035
climbing,5607,5661,54,44.23658540254452,42.26230721759454
sniffing,5662,5706,44,20.915843479966796,29.492882231416875
climbing,5707,5756,49,62.96003514994971,51.73181362415981
rising,5757,5811,54,68.88390873144894,35.51751120576311
trotting,5812,5834,22,247.81505310627435,32.978304111032614
walking,5835,5869,34,211.1783241284212,27.224086691873097
rising,5870,5929,59,47.462524945343084,27.525356173960663
walking,5930,5944,14,66.50032006690427,33.898592599085674
sniffing,5945,6009,64,20.918378253046196,24.840568688260827
rising,6010,6024,14,26.838939112225713,33.29036159078905
climbing,6025,6059,34,34.02228813004011,39.69475384989547
sniffing,6060,6119,59,20.27678787119893,26.326357278107817
rising,6120,6124,4,36.522339632078925,36.62279796583542
climbing,6125,6184,59,51.79718276625637,43.167259018100594
sniffing,6185,6199,14,58.937859483620265,30.57773649089166
rising,6200,6224,24,42.12664696215607,32.418178620443676
right_turning,6225,6234,9,162.76563112847222,32.09183527627163
trotting,6235,6248,13,272.58417464526326,32.826600184141824
walking,6249,6285,36,210.47087943008574,31.705641253438866
sniffing,6286,6375,89,57.02278044325673,28.436087233444873
rising,6376,6380,4,42.843321463172956,41.381482255689285
climbing,6381,6425,44,42.52308467563181,43.530308261997114
right_turning,6426,6455,29,82.70108759496061,36.048704352854266
walking,6456,6501,45,193.16716622104235,31.68883418620598
rearing,6502,6516,14,36.327615693910644,35.572042399103076
rising,6517,6531,14,66.186665588831,35.38799612504014
stepping,6532,6571,39,117.8918311439234,33.41196903574676
rising,6572,6631,59,51.68411915989361,32.78881224060164
climbing,6632,6676,44,51.35985182167522,57.93714954595819
sniffing,6677,6706,29,49.128605806972,33.88107537692732
left_turning,6707,6731,24,97.83759879144841,37.62455216773779
trotting,6732,6784,52,259.7298773683966,29.80592981271074
sniffing,6785,6827,42,43.4032966952855,26.687968170723405
rising,6828,6842,14,54.005353670006656,33.7198963544327
stepping,6843,6890,47,100.36476170592759,28.716420246292483
sniffing,6891,7025,134,24.423871498785868,27.71772425970758
rising,7026,7075,49,36.560871958858876,40.99804633297883
sniffing,7076,7105,29,35.92294069976957,27.023838989521852
hunching,7106,7130,24,39.180236792932114,33.64710654147273
sniffing,7131,7135,4,63.203094195134305,29.339220520313013
left_turning,7136,7165,29,100.33109562234996,34.47433627527484
sniffing,7166,7195,29,19.15407734905018,32.71699418362872
stepping,7196,7207,11,79.5696878262297,32.07028656013345
walking,7208,7265,57,163.1310612056447,31.919511261993772
sniffing,7266,7315,49,28.17079219143111,28.716686242564734
stepping,7316,7375,59,66.12478819330748,27.08009142480979
sniffing,7376,7425,49,25.6914537775861,28.430155495030704
rearing,7426,7435,9,36.670647811421105,36.848961247925196
climbing,7436,7470,34,46.957833724678586,51.47175628524096
rising,7471,7510,39,18.555224114011516,31.54584421138056
left_turning,7511,7540,29,66.40500317922972,34.48117819244914
walking,7541,7647,106,154.45064003953985,32.67002566670829
stepping,7648,7707,59,94.36714532003907,33.69729082999116
rising,7708,7732,24,82.38666337155199,35.24819978899007
climbing,7733,7787,54,44.72423920983071,53.337415910709616
sniffing,7788,7797,9,44.22203007533827,35.76583934821851
left_turning,7798,7802,4,39.78332009676212,31.275946406269973
sniffing,7803,7842,39,44.57067373293288,31.98613839831064
left_turning,7843,7911,68,110.45371219280926,35.20036602349665
walking,7912,7942,30,204.4164348179069,30.996154635525127
stepping,7943,7987,44,109.37114718492639,33.4313633993957
sniffing,7988,8092,104,70.34079618956959,31.53261945450613
climbing,8093,8142,49,41.75774345427696,47.88577728158809
rising,8143,8192,49,56.09141866830855,31.033469261245745
rearing,8193,8202,9,30.602674633438816,39.66210878093314
climbing,8203,8247,44,46.77396870527289,48.71349389190858
hunching,8248,8287,39,23.25028617313261,36.15957987454168
sniffing,8288,8337,49,49.13993144960957,33.3946598665747
left_turning,8338,8352,14,99.52848408719383,36.682010189340126
walking,8353,8384,31,222.49186930584878,35.060455977244
trotting,8385,8410,25,250.38892264927594,27.850287387355653
sniffing,8411,8430,19,57.53095523518475,29.49383374979637
walking,8431,8432,1,140.63173653372422,24.096897976336372
left_turning,8433,8454,21,118.52696220656203,25.57639380301049
sniffing,8455,8489,34,55.33464671621424,29.088313920219658
climbing,8490,8549,59,42.48363040544546,56.05236830765658
rearing,8550,8564,14,41.80880306739401,35.37939823050101
sniffing,8565,8614,49,21.944859544145046,30.19980138387085
left_turning,8615,8668,53,98.76052400016245,32.120189437849454
sniffing,8669,8703,34,17.032343441070662,29.033387537309014
rising,8704,8723,19,46.443835721795466,35.35574038520643
right_turning,8724,8733,9,161.56806167447843,36.08353988469621
walking,8734,8800,66,129.95566841067583,34.411143163186715
left_turning,8801,8832,31,121.0518237271352,30.827115039260725
sniffing,8833,8857,24,44.96829898154794,28.93348157513341
right_turning,8858,8882,24,86.1530897137701,31.39622496841883
walking,8883,8892,9,145.0045178876223,35.669490817290615
rising,8893,8932,39,36.94348608296963,33.7023395208868
climbing,8933,8982,49,41.56009887048183,56.9759804786018
rearing,8983,9007,24,17.433806860035748,38.32878235851958
sniffing,9008,9052,44,24.651264067851535,29.775682026394115
hunching,9053,9082,29,26.19850120950918,36.490701993605896
sniffing,9083,9157,74,40.09585151760913,34.73573326330186
grooming,9158,9212,54,24.1680744725916,30.87924221286811
sniffing,9213,9332,119,24.90758490204371,33.53154972058124
right_turning,9333,9372,39,66.38224712238461,32.76578847576429
sniffing,9373,9397,24,42.24324670183256,31.81539007377799
walking,9398,9471,73,148.51381433196556,30.32548652668591
sniffing,9472,9506,34,54.11639493536771,29.868940225810306
rising,9507,9536,29,77.77733407806062,35.61280813063443
sniffing,9537,9601,64,45.379341587509494,31.984106628115015
left_turning,9602,9642,40,94.20970657860869,29.82174451685577
sniffing,9643,9732,89,18.88382448387459,26.98419783512119
rising,9733,9782,49,40.76458910903889,34.07364589343728
sniffing,9783,9832,49,23.77654390089966,28.444856639398363
rearing,9833,9892,59,31.399144532574212,35.645647393061
sniffing,9893,9932,39,57.48882691182861,33.2255712381156
left_turning,9933,9942,9,88.8401079870608,29.006546052276757
sniffing,9943,9980,37,73.84981431038987,31.254168392677162
walking,9981,10016,35,147.4304037477165,32.59832137776996
left_turning,10017,10063,46,123.44871509018374,32.74109745042049
trotting,10064,10089,25,221.0689968501269,28.19720334206843
stepping,10090,10124,34,49.416205631278785,27.897872872886172
walking,10125,10156,31,126.72966480512618,25.38281893685346
sniffing,10157,10206,49,18.27380306332155,23.14871767105192
rising,10207,10216,9,39.25311888321918,32.33006827777011
climbing,10217,10276,59,41.217204445762576,43.56592601589536
rising,10277,10311,34,45.20738257757577,35.6962595698586
sniffing,10312,10341,29,25.473659098094377,28.571530329408894
right_turning,10342,10356,14,78.98660289873084,30.009239022642532
stepping,10357,10466,109,81.00222179008816,31.667930415870053
trotting,10467,10494,27,260.8804900763327,30.821766824939356
sniffing,10495,10600,105,55.05668423867556,29.211585237005266
left_turning,10601,10623,22,121.52022127164699,28.709386987816284
right_turning,10624,10648,24,29.703841184660327,30.85959974679841
climbing,10649,10708,59,36.53139671266938,52.731596165338104
rising,10709,10748,39,26.716944394393487,33.20917578645069
sniffing,10749,10765,16,83.90888299220335,32.59354406773527
trotting,10766,10791,25,210.65450786415153,33.64805441603184
sniffing,10792,10836,44,48.46075827398647,32.281658278853996
left_turning,10837,10841,4,177.42687573202292,32.844088254828044
trotting,10842,10854,12,237.30237196995992,31.468456229824792
walking,10855,10884,29,165.13008669625668,33.520445280849565
climbing,10885,10944,59,51.31270831132981,49.17449254106976
sniffing,10945,10994,49,24.546957314160995,30.292725470426948
left_turning,10995,11009,14,168.9693282120522,30.92538715911663
walking,11010,11030,20,194.96834848088463,26.824899977435734
rising,11031,11060,29,67.04659963056766,28.166419546339384
left_turning,11061,11065,4,146.770360551762,31.143255885720407
trotting,11066,11083,17,200.3423169725919,31.151036272822733
sniffing,11084,11118,34,21.75571618926788,28.96213381718901
rearing,11119,11123,4,39.02825885659779,36.69273987009634
climbing,11124,11173,49,42.214345932409245,50.11957177632452
rising,11174,11233,59,57.057390067357424,32.10950623875752
walking,11234,11248,14,196.1248981792558,35.34213360661652
sniffing,11249,11338,89,34.48450197424898,29.422516944404652
rising,11339,11358,19,48.52618606367376,37.09073393500345
right_turning,11359,11378,19,118.3529921372995,35.66767280964773
walking,11379,11464,85,130.01845243555232,31.987321654678553
sniffing,11465,11484,19,30.440177421092812,28.062484210532137
rising,11485,11509,24,66.38953395654157,32.15500490278657
sniffing,11510,11549,39,34.9739423603836,26.745383781118555
rising,11550,11559,9,34.82317187557423,34.35246409563727
climbing,11560,11584,24,48.67450443065277,48.49600374646282
rising,11585,11609,24,17.118928392385403,34.363489063339564
sniffing,11610,11649,39,21.15810810650448,30.989719663312734
climbing,11650,11744,94,36.691181971530796,39.537320452361186
grooming,11745,11804,59,11.301999904684742,38.026790017828034
sniffing,11805,11819,14,68.36615095348981,33.50265177741296
rising,11820,11849,29,50.32427757963026,33.633355716192376
sniffing,11850,11914,64,55.93941170293973,34.62219245221405
walking,11915,11949,34,109.22701354342395,33.929223637438696
rising,11950,11974,24,65.11329570632532,36.772130315629454
left_turning,11975,11988,13,131.8396972792539,35.40021350234933
running,11989,12002,13,270.67978615619745,31.77290957961836
stepping,12003,12062,59,104.6366380597327,32.15723244478394
walking,12063,12095,32,186.518022854834,30.732801746706176
sniffing,12096,12161,65,56.284911110471555,27.703513600923774
rearing,12162,12171,9,47.79909502716883,38.49437489360281
climbing,12172,12196,24,47.84115445060362,53.302474433416826
rising,12197,12236,39,16.64855482807323,36.466626667825174
rearing,12237,12251,14,26.16379991077484,36.29840204977217
climbing,12252,12276,24,74.23963376778698,48.78119216290217
grooming,12277,12286,9,75.3256731530155,37.25407423883003
sniffing,12287,12412,125,42.62895634979759,33.94750833096571
left_turning,12413,12462,49,58.87092223683723,32.75240803949281
rising,12463,12487,24,86.58710754828132,34.56378570243325
sniffing,12488,12582,94,32.608258973241576,33.53438873483236
trotting,12583,12604,21,201.06196960136393,32.87975903073037
sniffing,12605,12644,39,28.822194516277,32.809471564139244
trotting,12645,12673,28,255.34142234514252,27.628112159075926
left_turning,12674,12703,29,118.98075987660802,26.663914654451556
sniffing,12704,12733,29,18.130980031004583,25.216387460458837
walking,12734,12743,9,50.60626709531432,33.36323176407713
hunching,12744,12758,14,48.88556151573451,35.4398649524144
sniffing,12759,12813,54,51.714278109256696,29.284412846137226
trotting,12814,12819,5,239.40795506156869,33.523594371689406
walking,12820,12854,34,143.35349843199512,28.321584179564063
sniffing,12855,12869,14,16.97828140279344,27.271629307989606
rising,12870,12939,69,71.51606737791327,36.499198009887856
sniffing,12940,12974,34,112.66631833902412,34.82668212967326
left_turning,12975,13014,39,63.82770596383595,34.46318744183452
walking,13015,13061,46,139.24451503200737,29.63633398339503
sniffing,13062,13111,49,28.60414390952308,27.86101945775773
rearing,13112,13116,4,66.10858283619139,41.08803835226634
climbing,13117,13186,69,66.40350600629787,45.978813404136616
hunching,13187,13226,39,25.481453096985295,35.91674483909891
sniffing,13227,13246,19,30.541886342178525,29.295210358945287
rising,13247,13271,24,57.52139789051194,36.15053268254056
right_turning,13272,13311,39,85.09822040186353,35.6840018478635
sniffing,13312,13346,34,23.312592300346942,32.97194232765711
walking,13347,13433,86,148.1937757156009,30.050993854402392
sniffing,13434,13463,29,18.382790395365813,25.0828774730128
rising,13464,13493,29,60.38532433638884,35.983829595666045
climbing,13494,13523,29,52.36301595811765,50.31139816405531
walking,13524,13538,14,88.96062502064473,36.51604533148313
left_turning,13539,13543,4,148.09128099948924,39.19159875286665
walking,13544,13586,42,200.07013899436686,33.34365117813076
sniffing,13587,13641,54,24.34731345838861,27.41585677879266
rising,13642,13681,39,23.33294557253062,29.581442896958418
climbing,13682,13831,149,37.455009209370985,44.80562371318565
sniffing,13832,13866,34,25.480107003127557,30.483277692757923
left_turning,13867,13876,9,73.71999213704927,30.111485692779944
sniffing,13877,13886,9,49.47434642180053,30.753114928703674
rising,13887,13896,9,55.02643633121735,37.28031898660778
climbing,13897,13926,29,53.94679627456619,47.045504914174735
sniffing,13927,13996,69,23.34286030843691,37.88785549074452
left_turning,13997,14046,49,62.387304616601526,36.340122299868334
sniffing,14047,14171,124,37.801861997840824,30.48040664496451
stepping,14172,14219,47,114.13797776339344,33.11554702186651
walking,14220,14259,39,167.58604401332613,31.679171341752955
left_turning,14260,14293,33,125.0719816066181,28.498761986515998
sniffing,14294,14348,54,20.36157139120862,28.311534760418656
climbing,14349,14403,54,59.42164900477914,44.76466797374623
left_turning,14404,14438,34,55.062287494377166,39.22101739821688
stepping,14439,14460,21,95.72939822558148,32.41255009219755
rising,14461,14475,14,39.23856431787474,38.51684106039671
rearing,14476,14485,9,35.73882273326158,40.47411859905608
sniffing,14486,14505,19,17.011537445013566,38.622777753089196
walking,14506,14527,21,126.93916670696322,30.739604941318078
rising,14528,14537,9,71.13418580222071,37.59749163954873
climbing,14538,14772,234,22.10623402711721,45.319846827689
sniffing,14773,14822,49,37.050079486022696,35.47403306858081
walking,14823,14841,18,148.42104685146546,32.22613060051924
right_turning,14842,14886,44,55.749604656883406,29.180093232005856
rising,14887,14901,14,25.814226334999464,36.795919522187894
sniffing,14902,14966,64,47.89915691010273,35.95853301197666
left_turning,14967,14991,24,54.827993470636756,34.55448057571373
walking,14992,15131,139,127.90404759262913,30.68265059943764
sniffing,15132,15161,29,26.669869774196624,27.877270918337448
right_turning,15162,15178,16,107.72508706432393,29.91855477013195
left_turning,15179,15202,23,92.26468044342214,29.108674072204206
sniffing,15203,15217,14,23.195869472107862,30.531213312235778
left_turning,15218,15222,4,74.35900336318056,30.25606711660364
walking,15223,15291,68,148.27087243557358,29.663575476240407
sniffing,15292,15406,114,13.498033413932475,27.41263096606964
rising,15407,15421,14,35.47475581454139,32.34759451852244
sniffing,15422,15476,54,22.268219382606873,26.990077630280616
right_turning,15477,15531,54,54.167197595399536,30.06625066450813
walking,15532,15556,24,97.69051590611969,32.93952126069729
sniffing,15557,15600,43,41.403797857938294,29.326855708402977
climbing,15601,15635,34,52.86346338166318,53.15298149605576
left_turning,15636,15640,4,127.65051207537631,30.261689324118436
walking,15641,15677,36,132.32844281364268,27.71072039570717
sniffing,15678,15701,23,47.39260108366731,23.104495658385616
rising,15702,15721,19,31.8304810065183,30.63923640210566
climbing,15722,15801,79,39.15575479859781,51.383292709326795
sniffing,15802,15876,74,24.131778629603115,27.979704117448843
rising,15877,15881,4,51.3156791999959,38.84247438787107
climbing,15882,15941,59,36.811523343526545,53.066557892455265
rising,15942,15966,24,58.37121114203023,37.609958548543794
sniffing,15967,16006,39,22.857105487732348,29.499995542265815
rising,16007,16036,29,59.62322694238447,34.71860218491185
stepping,16037,16076,39,101.47170874931689,35.883730296580694
sniffing,16077,16206,129,36.61296777356447,32.21011842469369
right_turning,16207,16258,51,49.096544720945495,32.690059407645975
left_turning,16259,16265,6,122.96644623970586,31.327361466842138
sniffing,16266,16305,39,23.493909728437853,32.62492316937208
walking,16306,16381,75,166.05134005141986,31.685714219830892
sniffing,16382,16416,34,36.38711116671581,31.136268827368276
climbing,16417,16446,29,76.11954615970906,43.42710414232165
rising,16447,16486,39,52.51657413619246,30.175579117517543
climbing,16487,16536,49,55.04035536948203,56.81255714413003
sniffing,16537,16541,4,74.19393747134438,33.544305732037195
left_turning,16542,16546,4,91.49129568536944,33.437851953042525
sniffing,16547,16571,24,63.6515885538982,36.65374948070409
left_turning,16572,16646,74,76.01559538592714,35.86692431388021
sniffing,16647,16661,14,30.45009424652538,35.27094073246311
left_turning,16662,16681,19,90.9190764966082,35.45847439551169
grooming,16682,16741,59,25.765560944584276,36.20480819741543
sniffing,16742,16846,104,25.919813336604186,32.92982823713375
rising,16847,16886,39,53.42963255482746,31.207654068665924
sniffing,16887,16981,94,38.66087021418822,34.88047288164054
grooming,16982,17041,59,23.523073439263893,36.25428744182469
sniffing,17042,17136,94,34.078942390399355,30.72381678092115
trotting,17137,17142,5,181.15245278692032,34.08281083473254
walking,17143,17170,27,203.9356035372412,30.80302421862455
sniffing,17171,17225,54,29.394553114195983,29.747273091183313
rising,17226,17240,14,98.84069695710144,34.62599472857285
stepping,17241,17260,19,89.36228171236017,29.696983503349248
sniffing,17261,17274,13,59.330114239420375,28.088136614296875
rising,17275,17299,24,68.41576890161784,36.308787329650656
climbing,17300,17329,29,56.503548864374714,47.45845300086446
rising,17330,17424,94,17.251685273021547,34.597686967029155
hunching,17425,17484,59,18.401411479934247,37.298044111989334
rising,17485,17544,59,18.42359190328176,37.41458413680689
hunching,17545,17604,59,17.96695978389748,36.73205544526194
sniffing,17605,17654,49,25.084387663252144,37.16625063480588
rising,17655,17694,39,24.76492118555909,33.558567850348325
sniffing,17695,17889,194,27.00179149842605,33.18923107629552
walking,17890,17928,38,186.28143291320856,36.37727566466137
left_turning,17929,17952,23,162.36537130623603,32.94320143001965
walking,17953,18000,47,130.09157876749168,28.169618407401188
sniffing,18001,18030,29,43.94776758785259,27.980107859608374
stepping,18031,18112,81,67.48926758267618,31.13309620357647
sniffing,18113,18134,21,56.42715082585464,33.82469480515712
walking,18135,18145,10,166.49854151134784,33.120814887516936
sniffing,18146,18205,59,41.59636407529372,34.124949343358885
trotting,18206,18235,29,291.0190183629649,31.02019538355164
walking,18236,18263,27,144.56596493691433,28.068725441152733
sniffing,18264,18293,29,21.304777024344062,25.691066128965634
rising,18294,18323,29,33.26931586524063,31.23298323929157
sniffing,18324,18343,19,35.20037135403558,28.83807424574396
climbing,18344,18388,44,56.41198028407263,44.90605888158621
sniffing,18389,18423,34,31.082046495129575,35.20478203017298
right_turning,18424,18428,4,117.9512424207683,30.185432857470097
walking,18429,18480,51,157.40687643754842,30.144881320184332
sniffing,18481,18636,155,28.16662419540875,29.889812155177932
walking,18637,18660,23,114.44489530726707,27.715162897702754
sniffing,18661,18703,42,32.98335484941713,25.3578421695365
climbing,18704,18813,109,38.369420991291115,45.780339113570285
rearing,18814,18873,59,19.05680104604058,32.7269818808993
rising,18874,18938,64,29.172684310728528,35.8843726663412
sniffing,18939,18993,54,14.787690720690636,29.510971984517056
rising,18994,19036,42,51.125557286007165,30.648909859257518
right_turning,19037,19041,4,144.24518202834204,31.484534139899324
walking,19042,19112,70,142.70510826453105,31.500677488419033
sniffing,19113,19182,69,43.16387346562817,30.165174610576624
walking,19183,19215,32,155.20151631700617,29.68310522571867
sniffing,19216,19370,154,45.13465372088118,31.251314211674448
walking,19371,19404,33,185.54853415266618,32.14147698667939
trotting,19405,19417,12,246.31417279764614,30.860009522576714
walking,19418,19437,19,176.7441740852766,29.32343108770243
sniffing,19438,19481,43,44.45367267523275,29.448744719666887
left_turning,19482,19516,34,87.41209121458569,27.991250629572807
sniffing,19517,19533,16,27.36789376091343,28.009464900608965
rising,19534,19538,4,44.40219925380303,34.44556512943798
climbing,19539,19593,54,49.5798966995826,38.69486148544401
sniffing,19594,19644,50,55.85924305696003,30.247731072357546
rising,19645,19659,14,78.56695466638233,36.55530760915046
sniffing,19660,19708,48,44.41826495792608,36.458974155919776
walking,19709,19759,50,180.4740532510446,34.57618869275994
sniffing,19760,19789,29,18.1390290872723,30.948566933021482
walking,19790,19810,20,142.90733479763077,29.436724219204795
sniffing,19811,19843,32,54.745309802168315,27.959420040595386
rearing,19844,19868,24,25.84735646049798,40.731160251656796
hunching,19869,19923,54,29.443693792286652,34.57594535251096
climbing,19924,19953,29,52.273027715816724,52.25839873194469
sniffing,19954,20013,59,36.58857025347927,31.627226578594556
climbing,20014,20053,39,49.44790025956505,52.01494422566702
rearing,20054,20108,54,15.208362372996612,39.53215681237257
rising,20109,20168,59,15.131114442863243,35.21651965825594
sniffing,20169,20468,299,30.50551965790146,33.60693653489205
rising,20469,20478,9,31.980091108249155,33.1832526033896
rearing,20479,20513,34,49.894479873548384,38.9814516144848
left_turning,20514,20518,4,100.53947567561059,32.517553299215365
sniffing,20519,20547,28,26.800631150980063,32.27364539814952
stepping,20548,20577,29,44.19323845786083,30.691712235827108
sniffing,20578,20692,114,14.186974105029476,31.642899941945192
left_turning,20693,20718,25,59.52829448718475,37.96148159037711
walking,20719,20785,66,157.67668044063112,32.967755278977535
left_turning,20786,20815,29,75.67686137429737,29.10053077509425
sniffing,20816,20870,54,27.332694270783126,31.174969958283658
rising,20871,20890,19,90.36131724440818,34.3053511510028
walking,20891,20907,16,112.38668348387506,28.117799430801597
sniffing,20908,20932,24,20.34300416868932,26.303597709234552
climbing,20933,20987,54,49.882408741832,53.62317641678205
rising,20988,21017,29,78.48328102523575,36.65124882376885
climbing,21018,21072,54,65.00240150375838,45.67485935209594
rising,21073,21122,49,52.40265320816883,34.46787811713574
walking,21123,21127,4,162.54655736170307,35.26651258333468
climbing,21128,21182,54,57.50240327309141,43.92242956782605
rising,21183,21192,9,75.88717205313807,33.25259494519543
climbing,21193,21247,54,60.190415905323896,49.52231882366566
rising,21248,21282,34,19.906827949867907,35.53295979569081
sniffing,21283,21327,44,68.37912259461174,31.53151936536114
trotting,21328,21360,32,270.4423519078068,35.08666221343904
walking,21361,21398,37,97.02105434797755,29.4740592127755
rising,21399,21451,52,70.5075442902659,29.765637661512358
left_turning,21452,21495,43,108.81563191594573,29.129213646301253
sniffing,21496,21560,64,45.95592179591214,30.148512553805126
rising,21561,21584,23,76.29380852424617,35.25966938738932
trotting,21585,21594,9,201.63500538674265,34.29214794464228
left_turning,21595,21631,36,103.5219857960567,33.630249643962784
walking,21632,21669,37,117.85895623278675,27.48924809685924
sniffing,21670,21729,59,18.044550711330015,26.167738732664485
walking,21730,21773,43,66.98059372255697,25.898323608087853
sniffing,21774,21802,28,35.90166106945197,28.59339896990149
left_turning,21803,21884,81,92.38741365818015,30.923010437828445
walking,21885,21951,66,144.4402384782033,30.726543856130164
sniffing,21952,21989,37,61.19678672549638,31.078366004225042
left_turning,21990,22035,45,100.80370212271885,31.466341520496304
sniffing,22036,22060,24,34.75665174526626,28.775301405443685
right_turning,22061,22107,46,86.32780658866778,33.02524658279342
walking,22108,22145,37,103.58159792742313,30.396626283166185
sniffing,22146,22168,22,79.61982326421689,36.78213638258471
left_turning,22169,22173,4,43.847272281707625,33.494844742741265
sniffing,22174,22263,89,37.25846251185449,33.46921453977652
climbing,22264,22298,34,39.02458161141859,55.21516796582239
rearing,22299,22333,34,20.412598233626944,38.06373458978566
sniffing,22334,22403,69,22.03316763233284,28.800008905154378
left_turning,22404,22441,37,64.63576557753,34.62281824686692
running,22442,22471,29,332.3966162463035,36.557464977133236
sniffing,22472,22624,152,19.030687981522153,31.447456960779736
walking,22625,22648,23,156.19316258261634,30.445731518120994
sniffing,22649,22675,26,44.52869403558848,30.295629824923505
left_turning,22676,22712,36,121.32000644275807,28.024619955481942
sniffing,22713,22795,82,37.99913548030556,26.537782625844265
rising,22796,22805,9,20.68470916846418,29.53753436059703
climbing,22806,22860,54,43.92056333232155,45.182795607057194
sniffing,22861,22880,19,26.917127854505047,28.061599083655143
left_turning,22881,22940,59,50.70846332982332,31.054229962249885
walking,22941,22981,40,184.34243230111846,31.199953853788585
sniffing,22982,22999,17,55.26955556157436,31.939608891955352
walking,23000,23015,15,114.67360920262375,28.60897171363116
left_turning,23016,23043,27,102.29588152778878,28.96712583395155
sniffing,23044,23083,39,24.603878485311064,27.361327619406847
climbing,23084,23133,49,69.80172169044698,36.71304103181521
walking,23134,23152,18,206.19481478338284,29.97927638494771
rising,23153,23186,33,56.86410564534613,31.88011099283592
sniffing,23187,23222,35,67.89478089308035,33.86137336711352
stepping,23223,23266,43,47.05469309567986,32.53021072862162
left_turning,23267,23295,28,66.41170066742502,31.392396001805416
sniffing,23296,23327,31,52.593597337421436,28.335678562601124
rising,23328,23352,24,53.695142206037964,34.288573949893305
climbing,23353,23397,44,65.01786476388793,44.650728764532886
walking,23398,23402,4,51.83723396196011,34.81722846776387
sniffing,23403,23422,19,45.23952076077093,33.89687446420267
left_turning,23423,23487,64,100.43218550112543,33.04934570101519
trotting,23488,23528,40,226.15952586518293,31.19196059748252
sniffing,23529,23556,27,75.39572194570299,30.589630168473928
left_turning,23557,23597,40,89.41508400284215,29.578807266091093
walking,23598,23602,4,39.56116568970913,37.61818080563785
climbing,23603,23662,59,35.01741713484193,37.49902965448639
rising,23663,23697,34,97.71358611381433,35.57703742739979
walking,23698,23723,25,129.23145741446044,34.0844678097668
rising,23724,23743,19,73.76852264321109,37.50249798308392
climbing,23744,23803,59,50.792837332853104,42.681127098527554
walking,23804,23823,19,174.0972301671717,36.16454852805141
climbing,23824,23863,39,72.74454780611177,41.79946411670226
walking,23864,23883,19,67.21075525011125,34.44704084758192
climbing,23884,23933,49,50.67067142820224,56.38503362688939
rising,23934,23966,32,75.71683784890699,38.489590116069834
sniffing,23967,24034,67,55.63703704260571,37.15114411979091
rising,24035,24097,62,56.12015632976407,35.1894052822846
climbing,24098,24142,44,54.04939510741725,51.90176950240237
walking,24143,24166,23,177.3768468387655,34.36927668665826
left_turning,24167,24181,14,71.64044974511661,27.366840617437244
sniffing,24182,24224,42,46.89681111866719,27.59021256126466
climbing,24225,24259,34,58.079724226074894,47.67432475929864
right_turning,24260,24269,9,138.59277304315123,34.113095703123456
walking,24270,24298,28,162.82457330956274,32.06550765125958
climbing,24299,24333,34,73.51403834375772,46.28184148260082
trotting,24334,24338,4,207.1194945741991,34.841627953884846
walking,24339,24348,9,211.1980070412772,34.37803868594162
climbing,24349,24378,29,68.99438351941924,47.409815984402144
walking,24379,24393,14,73.53103768744045,37.13176634269327
climbing,24394,24453,59,46.21612785062246,46.92903891490551
hunching,24454,24493,39,20.50867957305877,34.76903376118942
sniffing,24494,24543,49,22.195934722912856,25.082870809243776
climbing,24544,24568,24,60.971388696090564,44.0342562826089
rising,24569,24611,42,45.384090591592766,32.79749330791632
sniffing,24612,24667,55,20.023884097678813,26.629063611293013
stepping,24668,24700,32,73.00232035173006,29.59484887837333
walking,24701,24731,30,100.63642000742482,31.889292348646688
sniffing,24732,24750,18,11.338114676733118,31.43549094907512
trotting,24751,24787,36,230.8852479348265,30.33887046930254
stepping,24788,24828,40,80.20497061074084,29.37626861387986
walking,24829,24878,49,134.1932489218112,29.303925619031624
sniffing,24879,24983,104,32.472629038070956,29.231004959718515
walking,24984,25019,35,128.81214760968942,27.88615709116537
sniffing,25020,25090,70,44.842387709273076,29.97008545216047
rising,25091,25130,39,25.906890498666588,37.33774547884187
sniffing,25131,25175,44,26.22423990192351,29.928350215832182
left_turning,25176,25231,55,97.30489227979686,34.412995970250044
trotting,25232,25246,14,226.11731032975962,32.012863731922224
walking,25247,25290,43,175.8064397954852,30.43591383726329
left_turning,25291,25323,32,97.28516779920733,29.88138619078694
sniffing,25324,25342,18,64.8863572961901,30.706909106652976
climbing,25343,25432,89,47.927390289794026,52.92536804318603
sniffing,25433,25481,48,58.52884921065255,37.462033457347665
left_turning,25482,25547,65,99.44700735787876,31.70738883518292
sniffing,25548,25562,14,39.25808666991915,35.30038697845955
rising,25563,25577,14,78.1292276084895,34.65753702766228
walking,25578,25623,45,153.4449976820085,27.776499514477
sniffing,25624,25642,18,27.827450309199936,28.316016232406934
climbing,25643,25672,29,59.32643051585933,42.83318762861922
left_turning,25673,25677,4,73.42911658221792,33.35256028367099
walking,25678,25771,93,161.83562783230985,32.4991690188223
sniffing,25772,25871,99,30.645602728331582,28.38510939468681
rising,25872,25886,14,34.4848067073466,32.85231603732655
sniffing,25887,25958,71,25.792026310315293,32.30371452730312
rising,25959,25988,29,80.58447789319358,32.03256077852238
climbing,25989,26108,119,30.3836844592381,44.64745996229708
rising,26109,26143,34,30.342419350238345,37.799647315148846
sniffing,26144,26178,34,33.610520191613745,32.150606306292694
right_turning,26179,26187,8,121.1025206652426,35.36884958587764
walking,26188,26227,39,185.76244818458702,32.145899809309455
sniffing,26228,26248,20,63.922241002131344,31.380759300281017
walking,26249,26290,41,118.5712396340867,30.11501330374816
sniffing,26291,26311,20,37.07077381739297,29.46677951096378
climbing,26312,26341,29,18.66746072981535,39.63256576384762
grooming,26342,26401,59,28.64556897152506,36.60229013305422
rising,26402,26551,149,14.392098391010665,31.209493627033567
sniffing,26552,26791,239,21.843510639050425,36.89068136595649
hunching,26792,26801,9,22.042089604500255,38.94768292291327
sniffing,26802,26850,48,13.61124979134579,40.91026900893272
pausing,26851,27001,150,15.324164779468456,38.64573083375361
sniffing,27002,27141,139,24.499948960737115,36.15627833689479
rising,27142,27181,39,17.102875936831936,35.90738482850214
rearing,27182,27236,54,13.658034059059657,37.89901044022818
rising,27237,27306,69,13.27579494416078,34.49805207565515
sniffing,27307,27420,113,23.35630385892405,29.171050131081007
hunching,27421,27460,39,52.74671595096952,38.378798885536035
sniffing,27461,27750,289,24.001166394331005,32.71120708160937
left_turning,27751,27778,27,104.26287805375651,33.98951430679712
walking,27779,27806,27,107.07988563307701,31.285275840414585
sniffing,27807,27831,24,50.52463141395944,31.493443918135448
rearing,27832,27866,34,21.45053792954282,38.70334508379513
rising,27867,27981,114,12.679526848365079,37.14970971522503
rearing,27982,28111,129,16.61182620548443,39.291753558912546
grooming,28112,28221,109,18.800778453531997,37.86730344942265
rearing,28222,28291,69,17.715912918922978,40.9807247425386
sniffing,28292,28431,139,30.42531846230383,36.834663118367345
walking,28432,28455,23,112.83394079396011,30.55075193187875
rising,28456,28505,49,41.18520713768052,29.224729716245808
climbing,28506,28565,59,35.357603436601295,44.56658740853816
rearing,28566,28575,9,32.53949122827667,35.60322436987854
rising,28576,28615,39,17.178416270675108,33.9442527868155
rearing,28616,28640,24,17.480489283476757,36.91904077488348
sniffing,28641,28742,101,44.23245105837952,27.763212324533292
left_turning,28743,28757,14,105.17113615859307,33.003151321488765
sniffing,28758,28870,112,39.60119983493878,29.593491730818904
rising,28871,28935,64,25.22630290710901,34.67216623835892
walking,28936,29027,91,110.58826833544012,30.244222730951748
sniffing,29028,29044,16,29.485451208098542,27.05338938832875
walking,29045,29049,4,51.59204314174856,33.04604436892323
rising,29050,29059,9,45.85636377827119,35.79884010553701
hunching,29060,29069,9,36.138488835325276,34.443245155207066
sniffing,29070,29214,144,25.957035259877916,30.294376552486767
left_turning,29215,29235,20,125.93420162250462,31.377907626825852
sniffing,29236,29311,75,34.04792530582023,31.40252064591824
stepping,29312,29346,34,70.54086846893247,30.12249081141133
sniffing,29347,29376,29,31.512212094737478,31.066184385289315
climbing,29377,29421,44,46.68196650131622,45.06559880980596
hunching,29422,29436,14,19.163925803709656,37.44999949928691
sniffing,29437,29538,101,43.3068269951047,28.716723770773303
rising,29539,29548,9,64.89094697233023,33.85687589532056
climbing,29549,29608,59,32.421317622150404,42.23175968578167
rising,29609,29668,59,15.161642373309757,35.326559560777966
hunching,29669,29728,59,19.873192075045804,36.15372407920439
rising,29729,29738,9,29.986454977379378,32.940234654452524
sniffing,29739,30406,667,32.77738100872843,31.980544005643527
rearing,30407,30451,44,27.06739115133483,38.17038200732132
sniffing,30452,30511,59,11.163550051796388,38.20037813929627
grooming,30512,30631,119,18.423079550264454,35.45608474854844
sniffing,30632,30811,179,20.76833298926059,33.129736929629395
rising,30812,30871,59,31.100772873811312,32.87856608766572
sniffing,30872,30961,89,42.533220430705036,32.00815604455381
walking,30962,30986,24,138.27641236228635,31.96194416860003
rising,30987,31010,23,54.369379905412735,28.05831883064758
sniffing,31011,31060,49,22.29798635611376,28.585326438517814
hunching,31061,31120,59,41.193419174664456,33.43618477042045
rising,31121,31135,14,66.87089419146287,34.45258190466692
sniffing,31136,31297,161,47.646334744811554,31.128542505533627
left_turning,31298,31326,28,89.32932466837504,27.882578882153595
sniffing,31327,31453,126,45.33836125192063,28.98430217191028
right_turning,31454,31463,9,58.92191524814082,33.137096499056796
walking,31464,31498,34,175.74736785850826,31.945830221384572
trotting,31499,31535,36,210.72796003005,30.192274574389767
sniffing,31536,31564,28,53.2733499400961,27.975482797890848
rising,31565,31589,24,53.46860363526048,32.2964385643796
right_turning,31590,31631,41,60.47818642559683,31.776989746107127
walking,31632,31642,10,119.71696544608864,31.67022517213604
sniffing,31643,31703,60,60.808382012613045,33.74813905471124
rearing,31704,31723,19,29.776763198094546,36.98464921766245
right_turning,31724,31743,19,65.52673448061043,35.928061778154785
walking,31744,31779,35,179.89571921980078,35.23074356327183
sniffing,31780,31816,36,71.91408752438139,30.92030172473667
walking,31817,31855,38,126.7223012818546,29.072056258815802
left_turning,31856,31883,27,109.69566407253708,32.383971289257076
sniffing,31884,31906,22,26.409918008690134,30.04999364227866
climbing,31907,31966,59,32.40485459703068,47.78384814286017
hunching,31967,32021,54,37.13197892059369,36.0231153226562
rising,32022,32041,19,62.81749671427385,38.22825290009753
climbing,32042,32071,29,68.52971770820412,53.95356562745266
rising,32072,32126,54,20.07074197962831,36.43116887852306
sniffing,32127,32141,14,45.58916204775626,34.272903037214675
left_turning,32142,32172,30,147.80932232267094,36.90131008799313
trotting,32173,32215,42,221.03460123660264,33.689927832409666
walking,32216,32249,33,124.59064951114436,28.896004419417903
left_turning,32250,32280,30,85.793554127147,26.6468649854978
sniffing,32281,32343,62,30.842237094596168,25.430035817690605
left_turning,32344,32385,41,85.75603401714004,28.94591370195348
walking,32386,32418,32,114.16737911373839,31.132115208347336
rising,32419,32458,39,34.90635284621674,32.908567909323764
walking,32459,32502,43,106.31807545942611,33.748635076247275
left_turning,32503,32528,25,129.43773126737602,30.449582511463536
rising,32529,32533,4,33.19150264184311,34.37311615189118
rearing,32534,32548,14,22.635504120584823,36.81060676974311
climbing,32549,32608,59,53.12399435666559,45.59944784901283
rising,32609,32663,54,36.31351700097478,32.07557313564329
climbing,32664,32718,54,52.73193895506083,50.77474432713249
walking,32719,32728,9,110.70937500568024,36.93828004486888
left_turning,32729,32775,46,87.51046548758272,35.416844462197716
sniffing,32776,32835,59,63.68061428252648,30.8396726936895
rising,32836,32840,4,29.13100566153181,37.05590963708522
sniffing,32841,32865,24,49.386145239054805,35.3882620647687
running,32866,32887,21,295.9061890773914,32.79830946652086
walking,32888,32904,16,115.2715095183516,32.52400456056158
rising,32905,32924,19,37.85439282847467,36.42753156148805
rearing,32925,32984,59,34.44542229321223,44.102471642095296
rising,32985,33054,69,76.59113834169158,31.832528974094345
walking,33055,33059,4,78.17425960190508,34.88139941660372
climbing,33060,33154,94,41.66803689512405,44.89604499035979
sniffing,33155,33239,84,32.95697306482415,33.98373268247686
left_turning,33240,33259,19,62.58076268862288,32.6511526597796
walking,33260,33299,39,133.06433542058062,30.928057479828
sniffing,33300,33371,71,54.047250508651494,30.312149454133774
walking,33372,33389,17,93.80840259409106,29.97349334959403
sniffing,33390,33424,34,31.788375537421324,29.547604046070184
rearing,33425,33474,49,19.817396882166125,38.60307680342498
sniffing,33475,33609,134,34.39671321050111,34.47408742906793
grooming,33610,33669,59,21.0217488043354,34.11951710351833
sniffing,33670,33724,54,38.465643447923924,33.47285345467464
left_turning,33725,33776,51,86.72913510340953,31.795780642437556
sniffing,33777,33821,44,31.2937825511535,30.288511388046928
rising,33822,33846,24,18.96190833028451,31.505611933382824
rearing,33847,33856,9,54.24473825898141,35.30739514679876
walking,33857,33871,14,71.24061306946015,37.29800773702926
left_turning,33872,33897,25,50.57642384015738,32.385749823657406
sniffing,33898,33922,24,32.52923323765376,33.64442254054123
grooming,33923,34042,119,22.937418245379337,33.51252902411214
rearing,34043,34047,4,23.1316659758951,36.16088844825468
rising,34048,34067,19,41.11644309096566,37.268296339593284
walking,34068,34111,43,166.9194983230918,35.23246355500879
sniffing,34112,34160,48,54.82104217543443,30.85879094635173
right_turning,34161,34185,24,78.20803285019288,32.03729484725628
walking,34186,34194,8,136.8134871999029,31.259668365430148
sniffing,34195,34207,12,57.49772270821017,32.46795732498282
grooming,34208,34342,134,28.365475037056644,33.56640675258458
walking,34343,34372,29,153.16431796125624,32.60234317961972
left_turning,34373,34397,24,75.65512590441438,30.65202373301448
rising,34398,34423,25,62.185406745704704,28.56544959135093
sniffing,34424,34495,71,44.10764476852595,34.342092134579865
grooming,34496,34530,34,35.463134262281415,42.27487868848354
sniffing,34531,34575,44,19.80789004497797,39.252115830054045
grooming,34576,34635,59,27.061065488429072,42.16094929173991
rearing,34636,34655,19,43.49671251695692,40.6383889057344
right_turning,34656,34660,4,203.91972250384575,38.91928815603778
walking,34661,34717,56,126.25523096154085,35.89927900397349
stepping,34718,34748,30,106.21254762655035,31.31300678948205
walking,34749,34795,46,83.70737747559949,30.195555899380977
sniffing,34796,34817,21,47.61716105253766,31.179870225490905
rising,34818,34888,70,35.87064237175569,31.874203838144286
sniffing,34889,34946,57,42.60605210166335,28.23571416055281
climbing,34947,34996,49,44.07057315214608,42.09698724526171
rising,34997,35011,14,18.235218075366028,30.744785552686157
left_turning,35012,35067,55,48.92169731964025,30.076552885704785
sniffing,35068,35148,80,50.61107045127915,32.934546403358674
trotting,35149,35165,16,221.35040788199365,31.345711423797958
walking,35166,35205,39,134.15974283887294,29.9443909807493
sniffing,35206,35251,45,27.145420480986687,25.953851067948563
walking,35252,35256,4,43.00052622291905,32.26141661963756
hunching,35257,35316,59,22.665487337606194,35.01515830395634
sniffing,35317,35361,44,20.18822823247121,30.733885522233177
hunching,35362,35386,24,43.84743197037986,33.89800026347685
sniffing,35387,35547,160,37.915113600788146,36.21097451249322
left_turning,35548,35581,33,81.15336984118525,31.314833439837262
sniffing,35582,35592,10,94.6845387889554,30.90271527930587
rising,35593,35612,19,25.866727828548942,37.78394009455252
sniffing,35613,35632,19,19.729077891217827,35.24875957973444
grooming,35633,35687,54,24.681870207570572,38.978279079439005
sniffing,35688,35747,59,27.781226459450053,38.083714195157754
left_turning,35748,35793,45,73.61194458029482,32.93384880747386
walking,35794,35823,29,151.9285728012724,29.614105262881026
stepping,35824,35837,13,42.45315946170461,26.029214140359926
sniffing,35838,35962,124,42.74176638520808,27.27204468628602
climbing,35963,36090,127,23.35911256981939,37.44135207608526
rearing,36091,36170,79,21.296172806091427,36.05583098212213
sniffing,36171,36204,33,56.84801451388334,32.91207685224311
left_turning,36205,36213,8,92.12516698909408,31.165833670926254
walking,36214,36250,36,158.5641511600458,32.40660585845729
sniffing,36251,36260,9,34.16398768152389,33.764163373585816
left_turning,36261,36294,33,103.55171935473396,32.417428841926785
walking,36295,36327,32,201.3585134066285,29.790268149709732
sniffing,36328,36350,22,88.8573917988878,29.35611110433537
walking,36351,36363,12,142.0391836016747,28.842434933519954
rising,36364,36392,28,64.01877882644834,30.495201652489566
hunching,36393,36512,119,14.720652163035114,33.81250183195974
sniffing,36513,36572,59,19.613673452176425,29.517547278958197
rising,36573,36603,30,40.217929178149895,26.92817309552666
hunching,36604,36638,34,42.961441731367856,35.34457678088646
right_turning,36639,36648,9,65.49179483906181,28.537652163494972
sniffing,36649,36859,210,16.02613490673359,33.6970529166777
left_turning,36860,36904,44,90.52140105036531,33.5527976328074
sniffing,36905,36964,59,11.093964176193092,34.49860562727129
right_turning,36965,36974,9,78.9230517036005,33.35733180851845
walking,36975,36983,8,156.08216687753315,33.67829207674995
left_turning,36984,37008,24,83.18891721721175,34.52524067645381
walking,37009,37042,33,208.12454972099587,27.99697064497306
rising,37043,37057,14,62.566354479074796,30.44233004194547
rearing,37058,37077,19,43.38935878204852,35.25395594873753
left_turning,37078,37092,14,76.54822569282287,30.469381182445776
sniffing,37093,37191,98,55.36153006973832,32.09858379645939
left_turning,37192,37226,34,85.27471111493952,32.21662505226805
sniffing,37227,37352,125,23.260439451414523,30.6243079581091
walking,37353,37367,14,194.06811142890697,27.554606231852492
sniffing,37368,37402,34,52.66889030731837,30.191576752968746
hunching,37403,37407,4,43.10144877519277,33.94583598766418
sniffing,37408,37587,179,27.79093820326045,31.587458581955293
climbing,37588,37627,39,30.938903864277698,36.82542313495015
right_turning,37628,37635,7,109.40026818926208,31.11135622968262
sniffing,37636,37840,204,31.902883983098413,29.586324434959465
walking,37841,37882,41,180.94076554197153,29.463888245113946
sniffing,37883,38087,204,29.341547499886673,25.616679092317106
rearing,38088,38097,9,53.627699180648186,36.89836160778701
climbing,38098,38122,24,65.43915635213362,47.19036524699101
rearing,38123,38137,14,40.65163200459314,34.563127513167885
left_turning,38138,38167,29,84.78165105642107,29.201444471841064
trotting,38168,38192,24,230.48126783492296,28.67428498771298
walking,38193,38223,30,181.63935590979173,27.881296972245732
sniffing,38224,38313,89,25.16066708556459,28.653197581582308
climbing,38314,38363,49,36.287306141730085,42.73214559483258
rearing,38364,38373,9,25.88361073879475,35.602734928332396
sniffing,38374,38428,54,24.784987643862856,33.25353572230914
walking,38429,38443,14,84.19975879901865,41.89267066198718
left_turning,38444,38461,17,148.9891590553126,37.09109888949598
climbing,38462,38501,39,49.27958607883738,49.34357426615746
rising,38502,38541,39,15.591941982748367,37.510671415325895
sniffing,38542,38551,9,20.19695076851585,32.094440537308415
left_turning,38552,38576,24,101.26133293338009,30.78779061080601
walking,38577,38620,43,175.87980510465792,31.061399882644135
rising,38621,38640,19,50.30374689405786,29.769865107350302
hunching,38641,38675,34,33.97826385717082,36.091388484662936
sniffing,38676,38770,94,45.32250537228325,28.803830861866448
walking,38771,38935,164,113.90286317449068,30.304459144903685
sniffing,38936,38978,42,81.73758321744172,27.96584753350836
rising,38979,39038,59,34.57802411483349,33.53491999524705
climbing,39039,39063,24,40.63795119729703,51.991063722231786
grooming,39064,39083,19,62.197340424102855,35.6108238780941
sniffing,39084,39114,30,66.19062870434342,33.21176786994895
left_turning,39115,39162,47,61.14996051548027,33.882339582225896
sniffing,39163,39190,27,66.5759998138542,35.596508827284545
left_turning,39191,39220,29,48.734256823227,33.08602755460472
walking,39221,39233,12,206.00325266463966,29.707180337113314
sniffing,39234,39284,50,93.38927661302877,30.40926555297284
left_turning,39285,39367,82,97.60825938609098,29.967873755791143
rising,39368,39377,9,30.174021326906995,33.7691835307509
climbing,39378,39437,59,15.905656817100892,39.26119851700522
rearing,39438,39462,24,57.92165850411544,33.93463949843755
sniffing,39463,39501,38,31.52064293838749,28.86160521458628
hunching,39502,39506,4,27.81307627598044,36.04868195222291
climbing,39507,39536,29,49.95231336533586,46.041127240754584
rising,39537,39566,29,48.26488345935751,36.292175548960316
walking,39567,39572,5,96.67388350060288,30.741212617608756
left_turning,39573,39591,18,103.64178800064212,29.083356247049856
sniffing,39592,39626,34,35.10060475503215,29.348751846058445
rising,39627,39661,34,47.80797911519561,35.67556681008488
left_turning,39662,39704,42,72.12997488448845,33.407617524559036
sniffing,39705,39722,17,62.33042319294465,34.42703881483541
walking,39723,39751,28,188.99914125486274,31.808019898625695
rising,39752,39795,43,82.46082642827702,28.935806765409144
sniffing,39796,39837,41,36.61473124960033,26.478547163444894
climbing,39838,39887,49,55.61979161229884,48.459716550098264
hunching,39888,39907,19,65.94635049632066,34.2947383577137
right_turning,39908,39912,4,128.2534699096725,30.888029474204473
walking,39913,39937,24,115.33759457855611,29.465809657254827
sniffing,39938,39967,29,19.872808181915026,29.44296873504847
left_turning,39968,39990,22,101.75158875396095,26.963480550776907
walking,39991,40035,44,83.22713188407108,32.80200263158104
climbing,40036,40085,49,50.08870247220232,45.273004999897346
rearing,40086,40105,19,39.2631709141636,37.80711750459525
walking,40106,40157,51,174.40770625419583,32.52689707111654
rising,40158,40178,20,42.88267346433612,33.97088585982343
climbing,40179,40238,59,45.72008927191293,53.921028903728136
walking,40239,40258,19,86.65425790974436,36.8505090703424
trotting,40259,40300,41,188.3173081295142,34.6424397578646
walking,40301,40327,26,173.8351521557933,30.479986059477437
sniffing,40328,40455,127,23.664917394331894,27.20051493406547
rising,40456,40470,14,47.62864951170981,32.42011767012372
climbing,40471,40530,59,19.95310187990058,38.95016660768946
hunching,40531,40585,54,28.88830505977906,38.26930837517864
stepping,40586,40590,4,99.62205448838665,34.22076120383257
rearing,40591,40650,59,23.19054687915138,38.83067879385438
rising,40651,40670,19,54.22020926624018,30.82922309609055
climbing,40671,40700,29,53.55704666517708,43.50086511839905
rising,40701,40710,9,53.187283131144866,34.766859366755675
sniffing,40711,40750,39,38.39044098319053,28.47439016332862
rearing,40751,40775,24,26.573594884756012,35.13467344249594
climbing,40776,40810,34,79.4546002698443,43.992080901997966
rising,40811,40820,9,42.05422496244748,34.80409672125049
right_turning,40821,40833,12,96.33054500526632,31.218776600743222
left_turning,40834,40840,6,104.90119538242206,30.71946466198552
sniffing,40841,40861,20,41.7387042248011,27.638749646052588
rising,40862,40871,9,68.98277426217595,36.02489345908584
climbing,40872,40906,34,54.77675184888503,49.45921151145505
rearing,40907,40921,14,89.61720976951236,37.208772631041285
left_turning,40922,40954,32,94.4255994661215,34.14633320904084
sniffing,40955,41043,88,56.638590429632906,31.8255157437128
trotting,41044,41065,21,265.77689102585384,31.817119159924246
sniffing,41066,41111,45,30.843257423129984,29.352096850694274
rising,41112,41126,14,60.53026385385492,34.754591179452035
walking,41127,41166,39,161.65871786016336,29.55991553667253
sniffing,41167,41184,17,28.94204520494781,31.92232180771135
climbing,41185,41274,89,48.134887098765404,52.01053095882061
hunching,41275,41299,24,66.6656553961419,36.569398106738205
trotting,41300,41304,4,133.4102642673928,31.593176628808425
stepping,41305,41319,14,93.30759897409192,37.31651310074952
climbing,41320,41359,39,62.39742628264455,46.83077867552349
walking,41360,41379,19,123.56291955279293,36.812341937921104
climbing,41380,41461,81,54.10787630326302,48.49878369306351
jumping,41462,41465,3,84.76023337439268,82.79207266983185
climbing,41466,41499,33,69.87614655283309,39.458079714688836
walking,41500,41539,39,109.02119329142496,37.7614123322075
rearing,41540,41594,54,65.334593003845,37.313366951541845
walking,41595,41619,24,139.24869996003252,34.43951749602306
climbing,41620,41679,59,56.6851505202542,47.232843879043024
running,41680,41684,4,254.41258862423928,38.08072549045609
trotting,41685,41702,17,244.074706044046,37.302485287336694
rising,41703,41727,24,31.77651405845554,36.475156301049736
climbing,41728,41767,39,57.81996262083675,49.7693147758475
walking,41768,41797,29,162.1615928605255,34.90743049849707
hunching,41798,41802,4,33.15374907871453,38.573665716416095
climbing,41803,41862,59,12.832449831731129,41.530349645337544
rising,41863,41877,14,46.43276575313098,38.3527424449749
stepping,41878,41897,19,90.8849157237805,33.73994677922134
rearing,41898,41902,4,45.83997365078618,36.90732638685934
climbing,41903,42002,99,29.387077292040594,40.450101188336404
rising,42003,42022,19,35.565359720220506,37.11912018799448
sniffing,42023,42082,59,34.121269036001806,30.399794663661737
climbing,42083,42142,59,43.723569744323264,44.19043067475389
rising,42143,42157,14,28.34874396916392,35.213816177188235
sniffing,42158,42194,36,20.729975754755245,32.54375782381114
walking,42195,42218,23,145.6654600441584,34.64123210806627
sniffing,42219,42258,39,70.17219579716364,29.384937864713415
rearing,42259,42278,19,35.1668650442581,35.68935261268989
climbing,42279,42298,19,50.84632354493551,47.17182958442912
rising,42299,42318,19,18.98591596168593,35.73024168941909
sniffing,42319,42363,44,37.84216884917552,32.3070837696818
walking,42364,42454,90,129.25139266830826,30.861101208993976
left_turning,42455,42519,64,88.63073642440229,27.76685544714999
sniffing,42520,42556,36,34.98982938658416,28.16555326634678
grooming,42557,42616,59,13.606426723181096,38.098104085956216
climbing,42617,42671,54,25.11597490271911,37.553283290792095
rising,42672,42696,24,26.478419929122413,33.51333684746709
sniffing,42697,42744,47,47.356452303166066,33.49951128363488
left_turning,42745,42759,14,127.8134633722097,31.60716647260049
sniffing,42760,42766,6,92.68734472929589,31.71053510226341
left_turning,42767,42816,49,84.69619770574798,35.483088259262985
sniffing,42817,42870,53,28.963115098063625,31.97129841460071
walking,42871,42914,43,143.34835094989037,27.236048534570205
sniffing,42915,43002,87,31.893923374558288,26.505529473706556
climbing,43003,43057,54,43.87539429108313,51.25109539641376
rising,43058,43067,9,21.144781476809403,30.34824422621323
sniffing,43068,43142,74,16.301600922061503,28.0038992609848
right_turning,43143,43155,12,123.47812834972214,29.40398016300565
walking,43156,43173,17,125.535357299979,29.37909636464275
sniffing,43174,43188,14,52.31747539400157,31.78807962902139
left_turning,43189,43219,30,85.95528720608444,27.934001693565918
walking,43220,43234,14,55.1707137653802,37.16782028843727
climbing,43235,43259,24,76.98323815850355,48.269586868973214
rising,43260,43309,49,15.778523379245039,34.45293504409674
sniffing,43310,43344,34,63.50324918594222,31.25854530279056
stepping,43345,43396,51,54.13700115999747,31.6353607705307
walking,43397,43428,31,162.37922252904724,29.205855870780567
right_turning,43429,43477,48,72.16791489315308,29.27736011785901
walking,43478,43500,22,129.4764212521429,28.617684133661772
left_turning,43501,43532,31,88.48692902311991,27.434706339878247
sniffing,43533,43734,201,26.31546305786573,27.865922957374494
rearing,43735,43939,204,16.041962185989803,35.43315303717014
grooming,43940,43999,59,26.23128086484763,34.64052166853917
sniffing,44000,44044,44,25.02781637667993,32.14949319918027
grooming,44045,44504,459,25.02552069664077,33.320325907687135
rearing,44505,44564,59,25.795926074090783,35.4442948929845
rising,44565,44669,104,23.692496873935813,36.38721856157212
sniffing,44670,44729,59,24.800833544438706,35.245687861110234
grooming,44730,44794,64,30.42327977923554,32.56628384152728
rearing,44795,44819,24,28.131078689288646,38.322278255717464
sniffing,44820,44934,114,24.831661116752635,36.58917590895982
hunching,44935,44949,14,16.111420738923428,37.9542261231695
rising,44950,44999,49,21.74240843824477,35.92488681508167
grooming,45000,45234,234,24.42851232236685,33.52189747401973
rising,45235,45289,54,35.56258367510231,37.01283295669578
sniffing,45290,45348,58,57.44144581225408,35.807243445854596
rising,45349,45363,14,50.444587289313716,37.58931305290249
hunching,45364,45368,4,41.018097278043136,36.523920107372064
grooming,45369,45638,269,26.580639680002214,33.36143606829788
hunching,45639,45648,9,26.85867558445982,36.734018591955056
grooming,45649,45718,69,29.281452687047423,36.85855115825581
left_turning,45719,45745,26,125.07028357727316,31.75051601754524
sniffing,45746,45784,38,50.59161472534858,30.591643538072677
rising,45785,45809,24,38.89434867356906,29.175627893017655
rearing,45810,45839,29,16.514185121136574,34.78904844982387
sniffing,45840,45954,114,38.17533342159085,31.69424440341304
grooming,45955,46004,49,17.125940010238192,31.18441499394706
sniffing,46005,46064,59,19.41151388269202,32.58101095871835
walking,46065,46085,20,150.19382590185919,34.574817604157545
left_turning,46086,46111,25,99.68339941024495,32.54419163362673
sniffing,46112,46151,39,61.027720305082404,34.265233423916
walking,46152,46156,4,173.67789986327847,29.20896975010241
sniffing,46157,46263,106,57.81377421357541,31.41477410168785
left_turning,46264,46273,9,107.81540164427027,29.033501842092853
sniffing,46274,46496,222,21.12762102821829,31.745076782331513
rising,46497,46516,19,27.12987150734703,35.321725180094816
left_turning,46517,46593,76,95.70281765535844,33.997206029562086
walking,46594,46634,40,137.48818777662993,28.364376626417823
sniffing,46635,46656,21,30.303218348337147,28.26771166277263
left_turning,46657,46680,23,85.13405678730571,26.782807488070574
sniffing,46681,46772,91,22.952506832222635,27.89180763174954
hunching,46773,46807,34,35.631881194499165,34.60363746777847
sniffing,46808,46835,27,26.05746312656292,30.81239479973466
walking,46836,46852,16,111.41617164328218,30.327821743273883
sniffing,46853,46891,38,71.6524220437368,30.836250357160242
walking,46892,46920,28,97.67483260169438,33.2203203568642
sniffing,46921,46952,31,31.10952512590005,32.14461426803083
left_turning,46953,46994,41,91.89154628964951,29.434063946968486
sniffing,46995,47054,59,53.03617142700758,25.36279032557741
climbing,47055,47099,44,43.46867729467272,48.894380685988686
rising,47100,47144,44,16.230494361722577,35.36183614644942
sniffing,47145,47293,148,25.398390950169404,27.91968395451075
rising,47294,47308,14,56.66964409213323,35.88982257632965
climbing,47309,47368,59,26.667979783089194,33.2308147218787
left_turning,47369,47403,34,108.46337286834401,34.57922919238749
sniffing,47404,47491,87,53.674181119419885,28.621862537068782
walking,47492,47497,5,124.26948051272451,25.752941118539592
sniffing,47498,47659,161,51.476196492747015,28.7974382941087
walking,47660,47705,45,168.6900855394422,28.392680140433384
sniffing,47706,47772,66,25.44267843146761,27.48032551466776
left_turning,47773,47818,45,112.0709996925183,31.238658716221156
trotting,47819,47843,24,220.11923143278946,33.09560787446428
sniffing,47844,47878,34,18.99458589673788,33.56553581142244
stepping,47879,47913,34,93.45399530310358,31.461337770388074
climbing,47914,47998,84,34.49794328191243,45.02065797842413
hunching,47999,48028,29,19.51877743747241,37.38358162087699
sniffing,48029,48119,90,32.643647220185265,34.04845037129237
walking,48120,48135,15,150.7627940664202,35.97083450589107
sniffing,48136,48192,56,64.27308621973054,31.080260447411785
rising,48193,48242,49,19.269214292719102,36.743288766873384
sniffing,48243,48262,19,40.4841647438765,32.32278884810578
walking,48263,48319,56,164.38021186880474,31.626078611261832
sniffing,48320,48360,40,80.41133972013363,29.277921349052498
walking,48361,48372,11,99.64235997019246,27.777332482894263
sniffing,48373,48420,47,48.400982719613104,29.127858678675526
walking,48421,48438,17,94.22355578548324,31.801828945239986
left_turning,48439,48473,34,78.0152257929088,28.54704204373034
sniffing,48474,48518,44,22.860731511139146,25.119708268475588
rearing,48519,48638,119,20.958959674978125,33.56513159482102
sniffing,48639,48663,24,28.73128476007191,28.904168803779314
rearing,48664,48673,9,34.847316494078015,36.69965930175583
climbing,48674,48833,159,24.245621263169745,42.80589833709955
rising,48834,48843,9,30.159401272018595,33.24225968756417
left_turning,48844,48876,32,86.53095795209926,34.93133137137475
walking,48877,48887,10,137.450062449033,33.86310612383546
sniffing,48888,48916,28,86.6508072808093,31.23195077446215
trotting,48917,48951,34,221.03335816861633,30.45230397465852
sniffing,48952,48985,33,28.2030076640931,28.415402331679537
rearing,48986,49005,19,29.686324733143415,33.889451520033305
left_turning,49006,49058,52,51.0533553075974,33.56559533124576
walking,49059,49083,24,113.6232491345135,31.269069067800636
trotting,49084,49109,25,229.08349369782627,29.740449209621545
sniffing,49110,49206,96,56.98123107502358,25.519321609833163
climbing,49207,49246,39,55.32137183969712,42.301889282096724
rearing,49247,49261,14,15.203933436160687,35.30282634804231
rising,49262,49301,39,17.165410380039525,33.51923442388483
grooming,49302,49361,59,25.010305251521807,33.905842307931444
left_turning,49362,49406,44,57.64205602368715,31.783924201887128
sniffing,49407,49589,182,25.55717413073305,33.019358143572994
walking,49590,49612,22,175.86568196825647,30.43317976173864
left_turning,49613,49635,22,92.68680322525451,30.734673682058368
walking,49636,49656,20,92.26544270048468,30.588027999838054
left_turning,49657,49683,26,94.16672140181934,29.979756120986494
sniffing,49684,49726,42,24.02359948566852,32.30803736011431
rising,49727,49736,9,27.82849663044583,35.673752635388055
climbing,49737,49756,19,28.834830775761446,40.22251745269234
rearing,49757,49771,14,27.982189928717606,36.42416890875389
sniffing,49772,49829,57,29.355032683401358,32.4943846142998
hunching,49830,49844,14,39.507425209644815,38.588983275843724
climbing,49845,49879,34,52.13633089085046,47.2305760563811
left_turning,49880,49894,14,120.14822982649864,35.50841483270977
trotting,49895,49934,39,261.3845168879717,35.56710933254467
walking,49935,49968,33,184.76419769166804,31.144916691607403
stepping,49969,50003,34,76.97630445253776,28.728707522932694
rising,50004,50023,19,59.682895593520485,28.844374461689988
rearing,50024,50143,119,21.648948490695886,35.89377249780182
climbing,50144,50203,59,55.68759782013388,44.88372771368036
rearing,50204,50313,109,20.664869991514347,36.38168752927199
rising,50314,50368,54,23.546830725768224,33.29314145210458
sniffing,50369,50531,162,34.34754374918588,34.197203880566484
walking,50532,50539,7,121.22992849177784,38.15658805976134
trotting,50540,50559,19,213.58265201774324,33.36069741439452
left_turning,50560,50577,17,102.52818748317124,32.080779586934156
sniffing,50578,50632,54,42.41760532034763,32.42425947957977
left_turning,50633,50659,26,103.99245455944687,30.28497176764918
walking,50660,50685,25,181.59316677969525,30.16659294686862
left_turning,50686,50727,41,123.37820505965003,29.503973644984566
sniffing,50728,50738,10,27.7529208240628,28.734840435432783
rising,50739,50748,9,47.6163335653096,33.95175907959653
climbing,50749,50808,59,36.98669052742564,38.434714530564555
hunching,50809,50853,44,15.336113664612462,36.497896998646
sniffing,50854,50910,56,43.523080168831704,29.93574685546191
rising,50911,50920,9,48.85518872667407,33.89806427567366
climbing,50921,50960,39,43.78220959858085,45.24381039240651
hunching,50961,51010,49,30.897899148547236,36.85239421288607
right_turning,51011,51013,2,214.27071993665524,33.60711455465417
walking,51014,51028,14,170.0361592422365,34.268619177955195
sniffing,51029,51081,52,42.70427218514334,32.77287911400607
walking,51082,51114,32,186.60264930422235,34.119182914952475
trotting,51115,51143,28,234.80123030706937,30.15387166641314
sniffing,51144,51177,33,44.18883225206947,27.356423547757025
walking,51178,51205,27,146.70388084200064,28.708173478101973
sniffing,51206,51254,48,26.471881803093094,24.267988039692526
rising,51255,51279,24,42.07797633201974,31.813481955150756
sniffing,51280,51334,54,50.421105436149304,29.4832191705374
left_turning,51335,51342,7,87.7430281191865,33.05861853273399
walking,51343,51366,23,132.73978812041676,33.6085885994197
stepping,51367,51397,30,90.1047284972668,30.124211154190707
sniffing,51398,51415,17,37.544783653754855,31.103240113769385
rearing,51416,51465,49,21.006404476680046,35.38279276202261
sniffing,51466,51595,129,37.35082749997462,31.293638379154913
trotting,51596,51619,23,209.85717425711925,31.37705936823026
stepping,51620,51640,20,119.76538652218187,34.03594216109904
sniffing,51641,51700,59,20.919384609698607,36.6113613196757
rising,51701,51748,47,19.93254126940757,36.26643189737372
sniffing,51749,51771,22,74.51181433548913,30.718404081531716
left_turning,51772,51796,24,85.5198218334812,30.680428376818927
stepping,51797,51829,32,78.63719736399814,29.794659781334712
walking,51830,51853,23,133.82383461193743,28.354414707725187
left_turning,51854,51864,10,71.37729181613533,26.415931114339283
sniffing,51865,51901,36,18.97338462023474,27.161975907581493
rising,51902,51951,49,58.358406605408234,30.837470353661246
sniffing,51952,52043,91,17.568733937373,33.261591891663144
rising,52044,52093,49,53.715932940588644,32.651027662692314
rearing,52094,52163,69,30.834348880280647,40.621084970203555
sniffing,52164,52278,114,21.38813169616442,29.781729150825704
left_turning,52279,52312,33,65.28792821079367,31.409372379351012
sniffing,52313,52405,92,38.83751201977455,34.1467176773047
trotting,52406,52429,23,217.71777458106328,34.56697591975453
sniffing,52430,52449,19,54.74225918543292,31.93705365757496
walking,52450,52523,73,141.51522474635138,30.023064851621005
sniffing,52524,52862,338,29.24078487387503,30.75182069943913
left_turning,52863,52872,9,108.30720524867363,34.52779633708951
sniffing,52873,53019,146,43.5897848848143,32.246701745314304
rising,53020,53034,14,43.23200469086611,35.43825724162056
sniffing,53035,53337,302,38.06175960376908,27.477498828980856
rising,53338,53352,14,37.86597829460249,33.3556177359762
climbing,53353,53377,24,66.78259664102144,44.25263547113283
sniffing,53378,53432,54,63.348726649425565,31.219682774270233
hunching,53433,53452,19,40.76082428814318,33.525210494395694
right_turning,53453,53467,14,90.87670934054073,30.988045944102428
sniffing,53468,53538,70,38.78735928320665,26.405590345864944
climbing,53539,53568,29,55.690162289850726,47.980934054349646
rearing,53569,53598,29,12.16779284014187,36.67116168578481
rising,53599,53658,59,15.426257884990168,32.97831549192948
sniffing,53659,53718,59,47.954689792645254,30.692768088902657
stepping,53719,53755,36,63.18342646432772,32.01925183718142
sniffing,53756,53826,70,47.82517394260288,30.55873956282411
left_turning,53827,53837,10,59.20805750792501,29.716797353268642
walking,53838,53926,88,167.62754996729768,29.99406131640936
sniffing,53927,53959,32,57.70253276752391,31.523112300930396
walking,53960,54079,119,126.63165807067384,30.539883422325126
sniffing,54080,54093,13,72.87490712536564,26.67063151821233
left_turning,54094,54129,35,92.14645147726364,26.79367317218466
walking,54130,54173,43,101.84844596230087,27.276042536764308
sniffing,54174,54225,51,17.169026009554337,26.635391340607235
rising,54226,54285,59,13.32929596387393,29.339336899390847
sniffing,54286,54331,45,24.931622727039656,30.13790492015171
rising,54332,54341,9,41.695683008349626,33.28171744817208
climbing,54342,54416,74,39.34616710101518,39.40888836502332
sniffing,54417,54466,49,33.2016813628869,30.336804995847775
right_turning,54467,54471,4,144.1775830186511,33.0770244413966
walking,54472,54477,5,117.34347213158509,29.447053843128348
sniffing,54478,54519,41,41.91614845119573,30.65192687909787
rearing,54520,54571,51,45.39695725040042,35.63916747518973
walking,54572,54609,37,117.35215480799462,27.541605298996
sniffing,54610,54635,25,20.856153999602782,25.507876847356613
rearing,54636,54670,34,21.972954534803932,34.04371357596711
climbing,54671,54720,49,40.59071934400322,45.44305275442767
sniffing,54721,54780,59,16.743651028716037,32.13364987590191
walking,54781,54797,16,166.8528062237877,30.769728051611416
rising,54798,54817,19,67.48861452907474,33.938352935618425
climbing,54818,54867,49,49.68690612355078,45.86297355950325
walking,54868,54877,9,73.03269020451003,30.182315204038712
rising,54878,54917,39,27.68924121991098,32.50490142743821
sniffing,54918,55001,83,24.251050312729532,26.13616448217091
walking,55002,55027,25,170.5148941760314,25.664511946292105
rising,55028,55041,13,69.21385252178732,28.39572932944073
climbing,55042,55086,44,55.514213960073135,39.04861902878992
sniffing,55087,55180,93,25.1616916654784,28.357354377674856
rising,55181,55225,44,41.62142533231345,32.64007870637692
climbing,55226,55285,59,55.920558040562355,44.02742502360233
rising,55286,55322,36,23.348032517014094,28.352443240783572
sniffing,55323,55376,53,45.18283865628061,28.572753651943973
walking,55377,55402,25,172.5844162410522,30.789813495735025
trotting,55403,55422,19,235.47395069843338,28.347413040232567
sniffing,55423,55432,9,59.74078412605953,28.875176964191816
left_turning,55433,55448,15,104.04378916916018,29.018387565202666
walking,55449,55486,37,92.80136420839342,30.102238831348558
rising,55487,55511,24,31.489843730435645,31.612330966852024
climbing,55512,55564,52,39.36148932472725,38.268071476020594
right_turning,55565,55579,14,109.31720419687719,28.64197491858694
walking,55580,55590,10,168.27739905186195,28.261804490570377
left_turning,55591,55600,9,78.58557876061252,25.847139282599038
sniffing,55601,55679,78,32.38427867181338,30.539409366297612
rising,55680,55694,14,31.894721782369402,33.95020181196793
climbing,55695,55724,29,36.65958883268118,40.10071323865843
rising,55725,55729,4,73.00574038425887,32.39339245976193
walking,55730,55734,4,76.8819264162365,27.687893612546667
stepping,55735,55755,20,104.71614059814594,28.667850455015405
hunching,55756,55765,9,56.9990657399444,36.099105281853994
climbing,55766,55825,59,34.88573823349126,43.7071361588975
sniffing,55826,55875,49,15.926550744133083,32.833584720445
right_turning,55876,55930,54,63.37744736299438,31.31846999996921
trotting,55931,55951,20,233.484938366903,29.426537308847628
walking,55952,55977,25,192.762047433268,28.099960964277237
sniffing,55978,56018,40,37.142568181058955,29.013102577154452
stepping,56019,56064,45,111.9015719226487,27.46098025734731
sniffing,56065,56090,25,104.87864348891068,29.615553490710717
stepping,56091,56098,7,54.21396309158012,28.105476075154925
sniffing,56099,56157,58,37.57206543153235,28.28657528421722
left_turning,56158,56190,32,89.2955210891325,30.920030257113016
sniffing,56191,56269,78,41.009465483191725,32.53001684538521
walking,56270,56319,49,137.11271793782288,29.35416629344344
sniffing,56320,56404,84,45.97362038263846,28.921298192239306
stepping,56405,56455,50,52.69643303115468,28.56106773030904
sniffing,56456,56558,102,37.97225792029804,28.78874041992119
walking,56559,56578,19,132.15415027078146,26.600455745400815
right_turning,56579,56623,44,80.5300260786546,28.026722862751736
sniffing,56624,56796,172,43.493647890274694,27.158330406753688
walking,56797,56860,63,174.041504164887,28.420184457086496
right_turning,56861,56941,80,70.37760530665565,28.637294417408242
walking,56942,56947,5,175.25266027355374,31.00228527739466
right_turning,56948,56950,2,141.97113091297894,30.17943217673448
left_turning,56951,56986,35,93.5260189025251,31.490348988383474
sniffing,56987,57103,116,52.3489651664392,29.220512553539805
trotting,57104,57113,9,199.29879054900692,28.600795058755047
walking,57114,57197,83,152.75520847727924,29.521560708829618
left_turning,57198,57224,26,121.70959115993594,28.722239220954027
right_turning,57225,57249,24,86.1637379170735,30.20260499563986
left_turning,57250,57297,47,108.47696551500648,28.940240707406844
right_turning,57298,57333,35,62.477352314613555,29.261843690204614
sniffing,57334,57358,24,47.71110511887292,29.031725714691866
walking,57359,57413,54,181.47651390014067,29.138864691619805
sniffing,57414,57492,78,58.82146149015787,28.480583709119465
walking,57493,57539,46,165.68468996501286,29.04626808483418
right_turning,57540,57568,28,128.0082087659031,32.1393268751079
trotting,57569,57633,64,223.38366759431864,31.00917496654483
left_turning,57634,57668,34,113.47975650457488,32.44006792344519
walking,57669,57702,33,153.72845752219,29.197888152970414
sniffing,57703,57784,81,67.36264264915364,25.354394028772788
left_turning,57785,57804,19,85.68938652393335,29.493553315611553
walking,57805,57836,31,193.74527615032866,27.988142149828672
left_turning,57837,57853,16,125.85336493530654,27.847412706449838
sniffing,57854,57864,10,104.91837262707018,32.842865880475735
right_turning,57865,57871,6,144.62234597099447,29.72538687819245
walking,57872,57891,19,167.11803527609771,28.09207267685024
sniffing,57892,57921,29,71.8968342189709,25.120252343586525
left_turning,57922,57956,34,85.35278693470839,28.36448095220348
stepping,57957,57958,1,137.47028452579133,27.232487498159312
walking,57959,57963,4,153.22198867253002,28.446776060072114
right_turning,57964,58003,39,109.46227236872456,30.116339648125177
walking,58004,58104,100,156.742769105633,29.80044240241612
sniffing,58105,58133,28,68.03897884223646,30.401945261768414
walking,58134,58183,49,89.07069594256467,29.517886746669024
right_turning,58184,58223,39,57.062149853641344,30.80469432932697
walking,58224,58303,79,144.9171852832077,31.609065589273218
sniffing,58304,58325,21,64.1669759235781,29.879621641313975
walking,58326,58353,27,122.65507848093462,29.028681802646087
right_turning,58354,58373,19,95.08146239598864,30.376173090189933
walking,58374,58408,34,185.52504245345045,28.621262608348342
left_turning,58409,58412,3,114.45745524374203,27.998940029528693
sniffing,58413,58426,13,58.279133567970824,31.748404772158004
trotting,58427,58458,31,218.91590963691974,30.873296831511727
walking,58459,58496,37,172.16731271137996,28.207058118274272
sniffing,58497,58517,20,38.01517417363476,26.691304042183003
left_turning,58518,58551,33,122.83584143592647,30.729638986167583
walking,58552,58595,43,203.60620528025885,30.55430537348069
trotting,58596,58627,31,220.60953610282655,29.909997893785548
sniffing,58628,58645,17,79.82246506574279,30.981967447874354
right_turning,58646,58656,10,156.1315481453444,30.820069536022814
walking,58657,58694,37,196.73282283590825,32.841498863051335
left_turning,58695,58718,23,93.40630591486074,30.77213250764589
stepping,58719,58805,86,79.65593622866326,31.1728111820821
walking,58806,58824,18,176.31713288327984,29.542804540358617
left_turning,58825,58854,29,97.22793908323499,30.428912744169125
sniffing,58855,58864,9,74.31265433374075,30.43173483736634
left_turning,58865,58904,39,75.79791299032544,30.12762408606476
walking,58905,58929,24,111.97759411298486,30.065526222838525
right_turning,58930,58937,7,132.79780009976446,30.143359265611494
left_turning,58938,58941,3,123.53372103172936,29.040266728215926
stepping,58942,58946,4,96.45393857770611,32.373418834133794
sniffing,58947,58956,9,51.23664095830908,31.874277787810804
stepping,58957,58986,29,46.755779166300925,32.33549528432892
walking,58987,59004,17,143.00462535419862,29.690974818307332
sniffing,59005,59063,58,67.80465195942534,31.46584895256612
left_turning,59064,59088,24,105.42205920634619,31.703049322376096
walking,59089,59121,32,134.90208532024266,30.30947490615869
right_turning,59122,59136,14,109.56420697147682,33.65126689243619
trotting,59137,59142,5,234.3291269734366,30.561455332499815
walking,59143,59160,17,204.70232496995052,30.414118002324066
sniffing,59161,59163,2,116.42508382366378,30.50022426738739
walking,59164,59165,1,74.72214618248603,29.42633347909242
sniffing,59166,59206,40,82.7452132236052,29.456646432949373
trotting,59207,59223,16,215.07206969280523,27.429996904542183
walking,59224,59226,2,191.42671833257023,26.785488105580928
left_turning,59227,59255,28,100.74277593605294,28.4197122482126
walking,59256,59284,28,150.53193393212834,30.924082543961756
left_turning,59285,59301,16,107.14895151349918,33.29616297410197
walking,59302,59396,94,154.08394308832914,32.00271537597169
left_turning,59397,59467,70,73.19560085688686,30.956127331260234
trotting,59468,59483,15,225.00863492075695,33.7763036256459
walking,59484,59505,21,224.99728648608297,30.072989342041
left_turning,59506,59633,127,113.57308292127853,32.22431742446054
walking,59634,59683,49,154.64247466522352,31.01123693230757
right_turning,59684,59710,26,68.75726979208376,33.17161957140956
walking,59711,59754,43,214.39403227968657,30.965377179033677
trotting,59755,59769,14,216.84993974775742,27.516246306442852
sniffing,59770,59771,1,121.54675115562367,28.700211517062584
stepping,59772,59815,43,78.33733206396002,30.592831973207034
left_turning,59816,59822,6,157.42094076010568,31.80685655100623
walking,59823,59880,57,181.51369524707914,31.201264023456957
left_turning,59881,59900,19,126.94384064701096,29.808575285112333
stepping,59901,59932,31,80.70227115953764,30.902255226630594
sniffing,59933,59947,14,82.61897712323513,32.675302817456995
left_turning,59948,59980,32,102.81235361106093,34.51437139661613
walking,59981,60039,58,161.94545800452715,30.46501131499738
sniffing,60040,60051,11,39.286911492555795,27.174387783027523
stepping,60052,60085,33,51.67148183495542,29.654564707992236
walking,60086,60186,100,126.88949309937131,31.59811263852665
right_turning,60187,60231,44,58.51649490140486,30.28836084313671
left_turning,60232,60252,20,132.20714846302303,29.13224484700492
trotting,60253,60260,7,219.5321253965435,28.463807750466586
walking,60261,60265,4,178.98105910149263,28.94431850165349
left_turning,60266,60298,32,77.1231306948196,26.454383499451104
walking,60299,60344,45,148.59768014848024,29.407638791133913
left_turning,60345,60378,33,100.53033710871567,30.8595979146076
sniffing,60379,60401,22,59.266848577259296,33.53182681993838
left_turning,60402,60447,45,81.00441478772369,33.30327951438619
trotting,60448,60450,2,194.50013578301233,30.903581070490215
walking,60451,60507,56,139.65987729888053,32.66862308815032
trotting,60508,60522,14,207.5717194411962,29.877417570766166
left_turning,60523,60560,37,74.12378093102087,31.03740436146915
walking,60561,60588,27,126.51893466828444,31.11208197420444
sniffing,60589,60635,46,33.40323393283197,26.30184947206659
climbing,60636,60676,40,35.18738347014157,38.87872653449345
stepping,60677,60686,9,91.8000121443497,27.06058442712989
sniffing,60687,60719,32,36.94038905217742,29.00678754604955
right_turning,60720,60754,34,54.81950495891855,32.11828819006322
stepping,60755,60793,38,105.75457215017235,28.723293713119766
right_turning,60794,60821,27,90.00323470528804,27.314346481830025
walking,60822,60829,7,119.50983449849957,26.985089439567858
sniffing,60830,60866,36,50.91115956285632,30.253670160799704
right_turning,60867,60877,10,98.29541698978905,34.25584033178939
stepping,60878,60926,48,49.58375509054728,33.9328066623736
trotting,60927,60967,40,205.01319848460608,31.231371087808157
walking,60968,61000,32,135.06270192320505,30.758374842714797
sniffing,61001,61016,15,45.99708045050462,31.508853087146242
walking,61017,61022,5,171.85805874526088,28.47181373755158
trotting,61023,61027,4,183.38063920329557,28.503582270731705
left_turning,61028,61045,17,88.34346789477807,27.699848163043114
sniffing,61046,61082,36,26.433867892850582,27.41209789613394
stepping,61083,61133,50,60.78224415151423,31.890538450362147
left_turning,61134,61174,40,71.36403976579145,29.574035402736477
sniffing,61175,61272,97,50.04720690505616,29.977076447987137
trotting,61273,61312,39,217.84813137447182,32.24999650915571
sniffing,61313,61360,47,66.78825609276792,29.654802663937485
hunching,61361,61420,59,19.38396653489123,39.0967059596394
rising,61421,61485,64,29.75383979861713,31.39315945635427
sniffing,61486,61531,45,39.39336121243674,33.3836352624212
walking,61532,61536,4,78.85757674581765,37.8361229542662
left_turning,61537,61561,24,97.20927946699327,36.357974657483176
sniffing,61562,61621,59,20.857250912916168,34.13142102272497
walking,61622,61630,8,110.11877333085555,29.698924212659715
left_turning,61631,61646,15,59.62150868864464,30.44516411020524
rearing,61647,61666,19,24.631408969067326,38.07888714304988
climbing,61667,61701,34,45.68678128464021,53.66621319861996
right_turning,61702,61706,4,51.23321929594215,36.24254704348213
sniffing,61707,61721,14,49.02870628838202,32.039839071381614
walking,61722,61731,9,90.79485971709178,40.46699117975295
climbing,61732,61761,29,53.47564963412882,52.43509718410065
walking,61762,61789,27,100.26862382713459,36.41739573748199
climbing,61790,61869,79,40.11357150014994,41.25903138398775
rising,61870,61902,32,53.96886291569475,31.95765354987882
left_turning,61903,61948,45,90.74631244061557,35.15384019619493
walking,61949,61959,10,120.21901526189603,34.14982855068797
left_turning,61960,61993,33,95.04780372722591,34.2218639826296
trotting,61994,62013,19,227.33683001963132,31.557511185322067
sniffing,62014,62019,5,104.61555086345084,32.7705904364478
hunching,62020,62079,59,56.04518460840727,35.61334335638276
rising,62080,62124,44,35.20566939006709,32.406662821859044
climbing,62125,62174,49,57.378292520465585,41.99645345697656
sniffing,62175,62203,28,48.56192639982277,35.29521142339285
walking,62204,62271,67,150.25065442053426,34.09304143965537
sniffing,62272,62306,34,43.84754360952462,27.454460588781096
walking,62307,62325,18,114.7444281133002,30.868576058213904
sniffing,62326,62379,53,33.634616678865164,23.705635882050565
climbing,62380,62424,44,49.446074332384775,39.11767681590731
sniffing,62425,62444,19,19.77292667243233,26.20331091216362
left_turning,62445,62472,27,69.30686623000977,29.066420913437582
sniffing,62473,62578,105,51.00310813278062,26.962443573745116
walking,62579,62640,61,140.83333764721823,28.82050632225765
sniffing,62641,62662,21,55.52415497426471,30.379123112265862
left_turning,62663,62685,22,127.65008756072142,31.117558639441615
stepping,62686,62718,32,93.30675080224121,31.832017332909015
right_turning,62719,62730,11,115.70978994668673,31.432711105383873
walking,62731,62795,64,165.60524666300552,30.350694571572234
sniffing,62796,62816,20,59.00830708868695,33.9581965523308
left_turning,62817,62930,113,122.81607727138724,33.38853768208145
sniffing,62931,62954,23,85.47044157311937,33.32777709584068
walking,62955,63005,50,120.39952346918311,32.93344670504539
left_turning,63006,63023,17,123.98243945960628,30.494519097539108
trotting,63024,63048,24,214.04842046920567,29.102178971416798
left_turning,63049,63081,32,134.7091254160145,29.054913084278294
walking,63082,63136,54,147.23791401580553,30.391868121826036
sniffing,63137,63156,19,36.777315586657856,30.638894559679365
left_turning,63157,63186,29,95.97016964045862,32.59831298609385
trotting,63187,63223,36,233.65294255783584,30.161472581594058
stepping,63224,63242,18,72.17664841464644,30.06227028905204
sniffing,63243,63346,103,46.78695071251746,28.795693463926618
right_turning,63347,63354,7,52.68097347458473,33.458757835969244
walking,63355,63381,26,175.10238637031125,31.73009913587739
sniffing,63382,63580,198,27.675274919542684,31.133182291185975
left_turning,63581,63614,33,65.62639874273411,32.110726541080304
sniffing,63615,63644,29,49.21139106344392,32.60637125527009
left_turning,63645,63676,31,55.531496208925915,33.640286814738985
walking,63677,63682,5,140.29251016978614,31.268741073014983
left_turning,63683,63684,1,133.02532590146086,30.302975251865703
sniffing,63685,63769,84,28.390233829697053,32.9870933523536
stepping,63770,63791,21,99.01132173248958,33.98390850013721
walking,63792,63799,7,156.89124876467278,30.98666147397561
sniffing,63800,63834,34,61.86479666853811,29.813363913216932
stepping,63835,63871,36,101.10633261341557,31.510561805129452
walking,63872,63910,38,132.76645929633824,30.323880181403137
stepping,63911,63959,48,72.46311311671822,29.723494457631066
walking,63960,64012,52,110.52681921374176,28.723781811802205
sniffing,64013,64044,31,62.74051215234476,32.1740822192037
walking,64045,64056,11,126.61814508616168,29.361919022053797
sniffing,64057,64094,37,30.672135395172674,26.91234204604271
climbing,64095,64154,59,40.732616594239424,46.72825041420146
rising,64155,64204,49,21.556337986936775,36.11109229656179
walking,64205,64225,20,73.07427577713945,28.759845064427243
left_turning,64226,64254,28,74.47012448007493,29.063118032715053
sniffing,64255,64291,36,48.59177852765692,28.49050278743223
walking,64292,64330,38,161.27039756494258,32.61330642894832
sniffing,64331,64339,8,59.549495033872326,33.682108444311
walking,64340,64369,29,160.018416668959,30.040717510402438
stepping,64370,64416,46,102.95396804438255,30.899756467552187
walking,64417,64429,12,193.54999679345264,29.061251269498914
sniffing,64430,64441,11,62.765035945093445,34.34508969708943
grooming,64442,64586,144,22.875520756798498,35.992834192015486
sniffing,64587,64683,96,29.84231579793976,33.66054310030501
rising,64684,64718,34,24.31673571079502,34.689983530201296
rearing,64719,64748,29,20.881911613160735,36.03284309416631
grooming,64749,64808,59,21.45875216305705,34.77482893558185
rearing,64809,64928,119,13.992052564159842,38.733933072423135
grooming,64929,65103,174,25.801502033968198,35.59150301146105
rearing,65104,65113,9,23.96439393523615,38.79835130268428
hunching,65114,65263,149,25.458318449407148,35.801903395700606
grooming,65264,65418,154,29.54031787169851,31.93859771643992
hunching,65419,65478,59,22.63345725139276,36.16239002172436
climbing,65479,65538,59,18.971706007856728,38.220625880127194
rising,65539,65598,59,24.174779955364478,35.01012067672052
grooming,65599,65728,129,28.51215175203057,34.210315428528446
sniffing,65729,65870,141,69.97092448356821,35.787761695896855
stepping,65871,65925,54,94.55616902506479,32.02382156658248
sniffing,65926,65984,58,23.84319842767935,22.612276376378254
left_turning,65985,66038,53,78.45359823785647,31.754342615858974
walking,66039,66098,59,210.49437575726486,32.68845733154707
sniffing,66099,66143,44,71.5282062752262,35.27546141043068
walking,66144,66210,66,190.8582243093823,35.36564041715665
sniffing,66211,66255,44,95.46479977709326,32.988843344284824
walking,66256,66320,64,163.63923534901238,34.70037470818661
left_turning,66321,66340,19,114.30469645771787,35.67184426413784
trotting,66341,66360,19,210.58314894295617,33.20503182454123
walking,66361,66363,2,155.23559661363768,28.29810482738515
sniffing,66364,66372,8,79.61965416548657,28.841220572835052
left_turning,66373,66416,43,147.00958182930935,34.40122484556401
walking,66417,66451,34,197.56021557777885,28.444358925982325
sniffing,66452,66458,6,128.52871749226202,31.918373481467643
rearing,66459,66468,9,62.8895506848505,35.32734137362895
climbing,66469,66528,59,65.2180235682474,42.02051621387352
walking,66529,66561,32,179.559086303608,33.723511271444764
climbing,66562,66621,59,74.41084804976182,44.204965902843675
trotting,66622,66638,16,240.7612702182839,34.0845258613062
running,66639,66644,5,281.7216732386533,31.462305789599
walking,66645,66645,0,273.9985934038112,30.09836049672409
trotting,66646,66654,8,256.3746123595434,31.615674864057787
stepping,66655,66675,20,133.14270520111694,28.566034731739542
left_turning,66676,66699,23,116.48171679229358,35.6070517587548
walking,66700,66729,29,168.22635534645326,33.93344545573901
climbing,66730,66844,114,52.8720596396299,43.477970915290015
left_turning,66845,66870,25,101.60866798657152,35.695007358006094
sniffing,66871,66877,6,99.97587892300928,37.54728683790489
rising,66878,66892,14,38.09759788950785,36.70301945626906
left_turning,66893,66929,36,91.01778009004063,35.883132964213395
sniffing,66930,66963,33,69.30324739896449,36.85271298694971
walking,66964,66998,34,157.67466173671937,31.22677022745253
left_turning,66999,67016,17,100.61333200620562,24.547157886768606
sniffing,67017,67034,17,48.42315422090886,26.12721777284838
rearing,67035,67059,24,19.135724316496177,33.560920242091434
climbing,67060,67119,59,30.891749766410122,35.3551588437809
right_turning,67120,67152,32,43.21099128219082,27.7164521024361
sniffing,67153,67172,19,49.12095670834929,29.387959386187493
walking,67173,67210,37,137.86278853214023,30.650702663923127
sniffing,67211,67240,29,74.34275327766596,32.13307656868649
trotting,67241,67262,21,208.06137155599296,29.942320538081983
left_turning,67263,67292,29,132.7894575749441,30.342790094328354
trotting,67293,67300,7,205.17288025865827,27.610576087756108
right_turning,67301,67301,0,135.97302454043344,28.31127835193325
stepping,67302,67353,51,81.45780073904794,30.510128502795315
walking,67354,67378,24,127.11145012830924,31.43169024176836
sniffing,67379,67437,58,32.40392091202448,28.704004286090687
rising,67438,67471,33,52.29292261791218,28.589944225652037
sniffing,67472,67490,18,31.484280762037816,26.166959436305707
rising,67491,67503,12,40.15702780905686,30.28712839959531
climbing,67504,67523,19,66.8618597333317,45.23412944465583
rearing,67524,67528,4,54.48101456535521,33.81135277496186
sniffing,67529,67567,38,31.46265595473167,30.20273229886156
rising,67568,67587,19,28.594501043842577,36.32176161583371
climbing,67588,67632,44,51.21240551597085,46.98508679712181
rising,67633,67662,29,22.144528797769883,36.070518394078555
sniffing,67663,67692,29,48.410546486277084,29.89551231564732
left_turning,67693,67731,38,70.27533527462914,33.01784072182737
running,67732,67759,27,291.39069120821574,33.38074139865104
right_turning,67760,67762,2,125.02592907287304,30.797409019069864
stepping,67763,67775,12,114.87570458756664,32.26258167804195
climbing,67776,67820,44,17.830383915732572,36.81389409137252
rearing,67821,67855,34,33.89266431892461,38.100028632068074
climbing,67856,67895,39,33.856963117857234,40.00592625662254
rising,67896,67990,94,28.630579495961232,35.95611544500087
climbing,67991,68050,59,44.23448923682273,56.77719098227839
hunching,68051,68110,59,40.45019846501268,33.87355558796398
climbing,68111,68148,37,67.67502878342866,36.08812514267665
walking,68149,68199,50,192.2463874811782,39.06402359899175
sniffing,68200,68263,63,72.45933900056278,31.880973874755846
left_turning,68264,68342,78,103.68374432381133,33.837259468816335
walking,68343,68364,21,202.8431841175733,29.142966835948915
sniffing,68365,68367,2,35.23426882739303,28.191573240352398
rising,68368,68381,13,75.16758671041839,31.23500375712891
walking,68382,68411,29,148.21310936289456,32.33355195120994
rising,68412,68479,67,36.49186212579914,34.41602844792139
walking,68480,68496,16,173.49191806012035,36.546632129536604
stepping,68497,68549,52,53.998692465452265,29.906931934647417
walking,68550,68570,20,137.5538092489559,33.384028734437734
grooming,68571,68585,14,33.20845401934566,38.546119334211156
climbing,68586,68705,119,65.61183402103225,40.157856505194665
hunching,68706,68750,44,36.186828424727324,35.130426871989975
running,68751,68761,10,326.87101817557067,33.69092618212076
walking,68762,68790,28,111.6523220419751,29.587636973816103
rising,68791,68852,61,46.24780394096953,32.824429672569075
climbing,68853,68911,58,60.389620265257264,45.094805579405275
walking,68912,68952,40,178.9342603614227,32.19291659707684
rising,68953,68984,31,84.29504250710751,35.93737732335329
sniffing,68985,69100,115,38.57574308211308,33.447643906558035
walking,69101,69132,31,213.40183818091745,34.90843450553051
sniffing,69133,69177,44,74.03198597426474,31.80305420172621
left_turning,69178,69190,12,89.25895881440442,29.644497486970355
sniffing,69191,69403,212,31.754156980193102,29.98490817965611
left_turning,69404,69420,16,65.6160263467423,28.335617391501614
walking,69421,69441,20,161.13251037277794,26.552263732175724
sniffing,69442,69469,27,35.486222284571404,21.498766434417032
rising,69470,69490,20,30.033121521081284,27.46009397757237
climbing,69491,69515,24,61.00451224131404,42.20652192904079
rising,69516,69550,34,25.247803796536,27.65095884170379
sniffing,69551,69587,36,54.726429290975254,25.626171968719607
left_turning,69588,69597,9,97.46433898750028,25.564609523149635
walking,69598,69603,5,72.25278505204845,25.954820040245792
sniffing,69604,69629,25,23.204387509004253,26.074313340527148
hunching,69630,69684,54,25.319524461041627,30.697422277893068
climbing,69685,69744,59,39.706949187425835,36.44368021728538
walking,69745,69759,14,65.04393610151331,34.23726992303673
left_turning,69760,69781,21,64.46670933502905,31.175598482117287
walking,69782,69790,8,171.063285446828,30.52159416672145
sniffing,69791,69830,39,72.29915815520344,28.352499410625324
rising,69831,69845,14,41.68221134338778,34.18732621002519
rearing,69846,69885,39,26.453096633266217,36.7466372305326
left_turning,69886,69916,30,64.55887611400729,30.143167311498765
sniffing,69917,69951,34,51.004858280068035,29.652962021801322
walking,69952,69965,13,126.86432665125244,29.407343164746475
trotting,69966,69969,3,193.9226577275206,29.90704859661166
walking,69970,69976,6,162.52483837389875,29.501334015286016
sniffing,69977,70059,82,25.13803377356516,29.453254694536252
walking,70060,70064,4,93.76495254489691,26.718263648929906
sniffing,70065,70133,68,48.31303197637183,30.16515300223315
walking,70134,70161,27,138.8197820707015,28.109558016632977
sniffing,70162,70173,11,36.62826077418584,26.737257352082764
stepping,70174,70188,14,90.85767020226298,26.80686236767285
sniffing,70189,70212,23,49.989518810917836,26.651215606962328
left_turning,70213,70227,14,50.65705521062464,28.3545967033108
stepping,70228,70240,12,57.07382432751508,25.398609325332295
sniffing,70241,70285,44,17.731178332459685,26.477510975122822
rising,70286,70320,34,39.489010920744434,36.044641411328485
right_turning,70321,70362,41,68.12549075254381,32.638727454509386
sniffing,70363,70409,46,76.64852153311806,32.90565496652137
left_turning,70410,70461,51,71.82472197854109,29.934197807108657
sniffing,70462,70508,46,51.033689732806415,32.3385631489269
stepping,70509,70525,16,106.41929419373442,31.513549208545015
walking,70526,70568,42,104.22689619465815,31.77639130139934
right_turning,70569,70585,16,96.9460501019387,32.092715285107545
walking,70586,70607,21,127.48676492766168,30.079669385687172
left_turning,70608,70649,41,93.83088090731239,31.166616673280856
walking,70650,70670,20,107.42517079958813,29.25442181748752
right_turning,70671,70682,11,145.72449106567504,29.060344077202284
walking,70683,70709,26,170.88164349092852,27.664561979434506
sniffing,70710,70766,56,29.983096702975512,27.952255599320765
walking,70767,70779,12,154.98265673267608,26.97812801748582
sniffing,70780,70790,10,45.174131585227855,26.29728830554568
left_turning,70791,70819,28,82.63036576627795,29.810839614955515
walking,70820,70853,33,150.47470730969863,29.783667160788934
left_turning,70854,70897,43,88.93143312538085,31.576789322288718
sniffing,70898,70937,39,69.7718955027722,32.222071027375776
walking,70938,70956,18,168.024891058395,30.015548074920424
sniffing,70957,70979,22,53.18047904731022,32.44762765318375
walking,70980,71008,28,182.0638858866488,29.7003202229492
stepping,71009,71023,14,103.97243735672515,29.820266243217382
walking,71024,71053,29,107.05820925203282,28.223961461287384
sniffing,71054,71093,39,47.43376073025665,27.84027515517767
right_turning,71094,71166,72,69.14835296572097,31.431537671051924
stepping,71167,71190,23,49.56442818397789,27.548921320592317
sniffing,71191,71254,63,51.739952165767185,26.442671507472518
rising,71255,71274,19,39.96018717876848,35.01698569327887
climbing,71275,71414,139,40.576408426566715,45.41899597578821
grooming,71415,71469,54,25.416509031599055,37.32975562676293
rearing,71470,71534,64,13.584843369749201,37.59079727958245
rising,71535,71574,39,17.723449646050106,35.21209343453411
sniffing,71575,71747,172,33.251703968608396,33.52318020662072
walking,71748,71749,1,159.03491483184592,33.47585366634202
sniffing,71750,71836,86,34.18052006024482,35.09680700419056
rising,71837,71885,48,20.199127636287262,35.893358379440265
left_turning,71886,71906,20,83.73817716415745,30.414149996090746
sniffing,71907,71988,81,33.41749689507534,29.604294020718253
right_turning,71989,72000,11,106.08145034545278,29.462465270065653
left_turning,72001,72049,48,107.5644324231819,27.591358210693727
sniffing,72050,72062,12,73.72009503949239,28.27276529108188
left_turning,72063,72092,29,114.45137814649334,29.514063502160173
walking,72093,72132,39,134.17707453347012,29.243655064355664
sniffing,72133,72153,20,24.74231801799716,26.907366038919896
walking,72154,72242,88,129.6542722854134,29.320068238318196
sniffing,72243,72292,49,33.45853309499498,28.698056251665484
stepping,72293,72338,45,49.48840412859705,27.30803789012675
left_turning,72339,72380,41,91.26764930788241,29.7705940415254
walking,72381,72419,38,133.7621291303835,27.17045003474157
stepping,72420,72453,33,97.99110088055563,28.52129006681919
walking,72454,72481,27,147.78166103617426,28.534511732572486
stepping,72482,72534,52,88.11820884242287,27.2220124721952
sniffing,72535,72585,50,35.37244705268382,27.465961126265466
stepping,72586,72614,28,61.58025101940995,24.077211071294215
sniffing,72615,72674,59,20.26225879940655,23.74265578783401
climbing,72675,72709,34,46.13562898785041,36.754167295609946
sniffing,72710,72799,89,28.30984545611147,28.90753062428199
walking,72800,72834,34,87.8787539599601,29.833726456157656
left_turning,72835,72884,49,120.82653404983238,30.359463186271824
walking,72885,72967,82,131.9473292684928,29.18845355835249
sniffing,72968,73012,44,59.1100710727767,31.13820447238636
walking,73013,73076,63,134.9368666073105,27.97020090315938
rising,73077,73089,12,62.19780777410086,27.907712407405143
sniffing,73090,73177,87,30.791020282738735,23.729452886157457
climbing,73178,73225,47,30.173076968382727,36.46278426870045
sniffing,73226,73244,18,20.59693163516862,26.674810253823207
left_turning,73245,73284,39,72.47295941482805,27.886124685115306
sniffing,73285,73345,60,43.899103302360004,31.9965024547207
left_turning,73346,73400,54,98.01457002965587,31.203615643579067
walking,73401,73511,110,108.84015699569846,29.854478271196157
sniffing,73512,73541,29,26.804621419154028,34.660270035082924
left_turning,73542,73580,38,50.61472768908226,33.06797504235749
sniffing,73581,73650,69,12.487838782476876,34.89600701318298
pausing,73651,73951,300,12.753380261386688,34.38120664476036
sniffing,73952,74060,108,13.472442773094743,34.369801845287796
grooming,74061,74675,614,15.660179517291317,35.99588060081002
sniffing,74676,74740,64,23.88234784337205,34.22787800782626
grooming,74741,74795,54,30.792241192353867,33.904152755166045
sniffing,74796,74875,79,13.940330883672056,38.89428183324301
grooming,74876,75115,239,17.359650679318246,36.40953359712027
rearing,75116,75235,119,18.28994095077601,38.887861528780995
grooming,75236,75295,59,15.978462910286941,39.56554711930415
sniffing,75296,75300,4,20.735163616725792,40.07140569550582
pausing,75301,75450,149,15.746373827654725,38.5613594054918
sniffing,75451,75719,268,27.428907799089664,35.18716641207366
rearing,75720,75764,44,21.247483359363365,35.89157653286755
grooming,75765,76064,299,14.756228494595325,37.34666683347749
rearing,76065,76114,49,22.890989540765187,38.046326488705525
grooming,76115,76149,34,15.831743044845098,38.57048706238192
climbing,76150,76209,59,17.724864567387296,39.00611633092625
hunching,76210,76234,24,38.561239362656956,36.53090808651145
sniffing,76235,76317,82,57.19757279639246,33.97955618870261
climbing,76318,76358,40,25.406702607430343,38.019688742336626
sniffing,76359,76415,56,44.541301929137084,32.24660104079772
trotting,76416,76440,24,206.25996955140232,35.31613995005784
walking,76441,76488,47,176.18331572908224,31.356532678401
rising,76489,76502,13,44.761548549864415,32.981536226593576
climbing,76503,76562,59,22.448721733460157,40.41470045400435
grooming,76563,76597,34,17.085572668970844,38.48915454738286
rearing,76598,76657,59,21.800843768914415,37.249260490053175
rising,76658,76678,20,43.9774430914059,32.1184111193986
stepping,76679,76693,14,74.92835262032375,29.536507331070933
walking,76694,76743,49,141.69174124642177,31.103646924113203
sniffing,76744,76759,15,79.6208691726021,31.867751938573996
grooming,76760,76774,14,46.10298324794499,36.03119495323141
climbing,76775,76799,24,73.31517795574553,41.70739369387009
left_turning,76800,76810,10,142.80033120921004,33.70618056880516
walking,76811,76822,11,176.59950141239952,31.642632437955026
rising,76823,76834,11,65.23927533069416,37.74578647034742
climbing,76835,76894,59,41.95009701577727,50.46650171766901
grooming,76895,76919,24,56.846579752155584,37.4145808598099
right_turning,76920,76939,19,70.93600126898222,33.37863537003772
stepping,76940,76981,41,97.69090380271788,33.810517017443566
sniffing,76982,77020,38,45.458603358624806,33.99744749771247
grooming,77021,77060,39,15.270255823432,38.032108118941515
hunching,77061,77105,44,18.10001630801165,36.750226006539755
left_turning,77106,77123,17,123.1688389524678,30.066529942301802
walking,77124,77165,41,178.79237500735582,29.854417330373842
left_turning,77166,77183,17,101.91755104811914,29.43433754432715
rising,77184,77198,14,59.213424331103205,34.59989180450449
climbing,77199,77238,39,18.473893369822672,36.5636533979713
sniffing,77239,77298,59,22.82919002202283,32.21775478042138
rearing,77299,77323,24,25.40054004185367,37.789524935083364
grooming,77324,77343,19,51.67830573496475,34.01056261774297
left_turning,77344,77471,127,86.77613722622782,31.106320816231968
stepping,77472,77509,37,51.75389769869898,29.209040488597708
sniffing,77510,77568,58,27.89870247855113,31.012280383351815
stepping,77569,77601,32,61.18381178602419,29.4637863392073
left_turning,77602,77690,88,126.55586497841242,28.026303387695457
walking,77691,77750,59,97.2070635894224,28.866099089655815
sniffing,77751,77803,52,32.073152729390436,30.75221607421246
grooming,77804,78008,204,13.047741835838124,36.03339436302804
rising,78009,78064,55,19.119900940112036,35.28674923441827
grooming,78065,78124,59,20.782921306577926,31.249490841357172
sniffing,78125,78310,185,28.32180698352322,28.43127491805363
climbing,78311,78395,84,29.949475178383828,43.28849824373942
sniffing,78396,78455,59,15.175744793815797,27.861806424983204
climbing,78456,78500,44,53.265320488455764,43.917386602251135
rearing,78501,78520,19,56.23522502448627,36.10940557885921
left_turning,78521,78599,78,85.87614462599535,34.163711942133034
sniffing,78600,78652,52,33.07447338887354,33.112239184529074
walking,78653,78741,88,171.42579889898218,29.36204874676507
sniffing,78742,78789,47,34.0488777712728,27.732876497697518
rising,78790,78844,54,21.805921468025915,25.61332939708658
climbing,78845,78964,119,30.489210258823825,36.93283773146876
grooming,78965,79234,269,27.776048225988635,31.386586728275642
sniffing,79235,79576,341,19.25230170866146,31.499002084923493
pausing,79577,79616,39,32.149036267004945,28.823833776169558
sniffing,79617,79767,150,29.301197820913156,33.954268768018025
grooming,79768,80287,519,23.924908402179053,30.046020790646022
rearing,80288,80347,59,25.72202276156783,35.317774095271226
rising,80348,80377,29,28.621458723533447,36.19853855236157
hunching,80378,80437,59,29.97145658540364,36.44349555829697
grooming,80438,81097,659,28.162451722039247,32.64989877626806
hunching,81098,81142,44,21.346108376724096,35.69069059937779
grooming,81143,81352,209,26.751672016700073,31.56189539477278
hunching,81353,81382,29,26.533565022215726,34.58425135668181
grooming,81383,81502,119,18.97439596204011,33.20595444978509
sniffing,81503,81552,49,25.466518447997043,35.65088311265495
rising,81553,81612,59,24.947843895229934,35.931607012669886
sniffing,81613,81617,4,31.624610118182755,36.36337358768684
grooming,81618,82092,474,27.43237093324131,32.490209811683975
hunching,82093,82212,119,20.838624898869043,35.6232143942286
sniffing,82213,82492,279,18.772240781355933,34.24682534996399
hunching,82493,82577,84,29.871882295279697,35.24762353868803
rearing,82578,82637,59,24.628049729434473,34.61787571138639
grooming,82638,82702,64,29.612592736182908,33.519479471124555
sniffing,82703,82752,49,25.445818484295316,34.88430464250104
grooming,82753,82987,234,26.874590197453742,31.533568871488804
hunching,82988,83002,14,25.30099958597329,35.745216270906866
grooming,83003,83152,149,28.92680047000882,32.31725941417821
rearing,83153,83182,29,21.215939426275025,34.86614560069527
sniffing,83183,83292,109,24.483972985766307,37.039149756512806
pausing,83293,83352,59,27.704357554495296,34.96766528254882
sniffing,83353,83400,47,32.82796187929674,33.919370518998925
pausing,83401,84451,1050,16.04789676362504,30.28364928644507
sniffing,84452,84547,95,20.39428854738176,31.94824335241759
grooming,84548,84847,299,18.161955273435584,30.29032490378783
sniffing,84848,85097,249,21.105759425993188,30.92682367657462
grooming,85098,85617,519,16.674775526976337,28.674081072317257
sniffing,85618,85733,115,22.52297504093584,33.872837503433644
grooming,85734,86023,289,21.594481695172476,24.90574695037714
sniffing,86024,86379,355,26.781794531721143,30.70547485413497
stepping,86380,86422,42,50.03029821791354,30.48378968113288
walking,86423,86524,101,84.87793037806924,26.535432181652226
sniffing,86525,86636,111,52.20086920158927,24.797257347681153
rising,86637,86658,21,31.995719449540243,27.30830407511447
climbing,86659,86718,59,39.29388655124899,42.354264843004685
right_turning,86719,86752,33,72.66557993302065,28.447270258735877
left_turning,86753,86797,44,117.58021917593244,27.151393150279667
walking,86798,86822,24,186.14598455601066,26.036541048484185
sniffing,86823,86915,92,32.24017602895809,24.8029067067261
right_turning,86916,86932,16,64.56235427411545,25.454687497044777
rising,86933,86965,32,58.12243143695566,32.37062883872515
sniffing,86966,87126,160,24.084930589602543,30.60364438237478
left_turning,87127,87174,47,83.05995070248855,30.432095821936358
walking,87175,87234,59,133.64452328072318,29.341601324056544
sniffing,87235,87287,52,67.70622166308954,29.942062743539676
left_turning,87288,87320,32,98.8070852180581,29.09165968033795
sniffing,87321,87450,129,14.44856154295876,29.075300869278845
pausing,87451,87601,150,16.179078273519103,30.888743225737265
sniffing,87602,87792,190,32.000185154241485,30.007230428337717
walking,87793,87878,85,130.9033872345188,30.174797449788947
stepping,87879,87884,5,119.25916659392173,30.741583845299555
walking,87885,87940,55,75.44978755023529,33.157447318906414
rising,87941,87961,20,44.147293348313525,30.44266730670351
climbing,87962,88001,39,40.49928948972753,51.57221206184878
sniffing,88002,88097,95,30.794738786164235,30.12269284492258
rising,88098,88133,35,43.207423097241225,30.96085580359019
walking,88134,88161,27,83.1687280653301,27.88886091112585
climbing,88162,88331,169,33.026008569010294,44.68527459246364
grooming,88332,88355,23,55.20320197311207,34.3565893119531
rising,88356,88506,150,27.328223139748392,32.70551706021443
sniffing,88507,88697,190,24.695006273565415,31.193195350553662
stepping,88698,88767,69,95.1674132699178,29.471466907896204
rising,88768,88806,38,30.71691608030347,30.416442300320607
climbing,88807,88841,34,50.53727852973867,39.030127602094886
sniffing,88842,88863,21,25.669091103859635,29.617552565863807
left_turning,88864,88906,42,71.31156791295928,31.818024193573212
walking,88907,88982,75,135.6617138995709,29.934768085290564
sniffing,88983,89106,123,29.06469025131601,29.766822389437383
rising,89107,89115,8,30.598355850241358,30.299590469491402
climbing,89116,89189,73,42.669044721341606,41.3770301766563
rising,89190,89210,20,27.106553056203104,33.05232238139467
left_turning,89211,89248,37,106.66070565475312,32.65758421929994
trotting,89249,89288,39,199.49765299491614,31.393782196543818
sniffing,89289,89343,54,28.051822165579384,27.677273837875667
left_turning,89344,89350,6,105.47923925441658,30.89428185129764
walking,89351,89365,14,149.5457042397538,31.77068341449918
sniffing,89366,89505,139,35.381321136830934,32.45019173260755
walking,89506,89534,28,90.02639696330829,33.01514489525455
left_turning,89535,89587,52,125.96856417387531,29.039804718870595
stepping,89588,89635,47,86.32444818778724,27.45113884328612
walking,89636,89666,30,112.75115300333175,28.847808887777692
sniffing,89667,89767,100,34.11670252838674,26.784104086465298
rearing,89768,89797,29,42.44779711847636,37.690344064496664
left_turning,89798,89814,16,109.01715058761533,28.512427631505957
walking,89815,89834,19,150.18889341458026,27.888777211288904
rising,89835,89867,32,56.087913158911,33.86830079647984
trotting,89868,89895,27,206.67796676604559,26.434138739810464
sniffing,89896,89955,59,33.984530964729316,23.245476902557694
climbing,89956,90094,138,38.32208479500559,42.02069636807571
rearing,90095,90114,19,16.824832849588915,30.128830991606996
grooming,90115,90129,14,29.476681653675577,32.07215967894175
climbing,90130,90168,38,40.41295454433068,48.54637634675185
rearing,90169,90177,8,68.9422593507857,30.129448123014566
right_turning,90178,90184,6,102.76236985309802,32.511352986541
walking,90185,90219,34,161.08808057512167,33.339069439121644
climbing,90220,90246,26,60.24297752213244,48.13555326619004
walking,90247,90284,37,136.93781222811364,31.83862326929749
climbing,90285,90323,38,83.81823649474227,33.139190999553634
trotting,90324,90355,31,267.17338323554947,29.744888291511018
rising,90356,90386,30,72.96846516121165,35.33479467078554
stepping,90387,90425,38,82.44287311580463,29.61813358480257
climbing,90426,90462,36,54.179348390841305,52.829645569919855
grooming,90463,90467,4,75.27929471020312,37.89516048805628
walking,90468,90472,4,138.37948282009881,34.97253437295024
trotting,90473,90482,9,208.89080463699975,33.30168991846689
sniffing,90483,90532,49,78.86219238799353,34.40714195926687
grooming,90533,90606,73,27.52695162519717,35.98262923817684
rising,90607,90620,13,23.913846398941217,34.79474704272543
sniffing,90621,90624,3,31.38907684837099,32.65212874689334
left_turning,90625,90651,26,66.82294802679448,32.3417392927049
walking,90652,90688,36,137.339522603123,29.907186500566848
sniffing,90689,90737,48,30.371257143349656,27.98790071297913
walking,90738,90756,18,88.59896534399834,25.068878239326455
rising,90757,90823,66,42.54207653344594,24.63772827999286
climbing,90824,90871,47,62.57132919353622,43.04011530860259
rising,90872,90911,39,58.90445056372971,31.166009389394514
trotting,90912,90963,51,205.8516615885412,29.682912004273803
sniffing,90964,90985,21,84.89303270195002,31.180103590788402
rearing,90986,90998,12,33.841450268799186,35.12616611350155
walking,90999,91034,35,66.24299411721901,32.257983318645664
climbing,91035,91076,41,30.675471466149286,37.47968176702551
right_turning,91077,91093,16,105.61748452211839,32.99583010539746
walking,91094,91137,43,195.1097037181389,30.203225106992704
rising,91138,91232,94,41.8439386570853,32.608872903316666
rearing,91233,91286,53,17.190128193434393,34.44197031312545
sniffing,91287,91355,68,40.040617458025785,32.324300307627674
grooming,91356,91410,54,33.09752707523898,30.84631648472096
rising,91411,91418,7,83.81952837129961,31.450917408090252
sniffing,91419,91498,79,58.959755096528355,30.843252632173822
walking,91499,91558,59,149.728893894842,30.10629690114979
sniffing,91559,91604,45,26.40624810540402,27.551220250512415
right_turning,91605,91647,42,108.40985818264896,29.05415560176534
stepping,91648,91699,51,73.6452456728614,28.40672828943535
left_turning,91700,91734,34,63.412861614025495,31.74087346159937
walking,91735,91785,50,126.65831953275178,30.430517099651617
stepping,91786,91831,45,80.69232475683677,31.045731871217416
walking,91832,91882,50,84.25274170634184,31.348288258652683
rising,91883,91938,55,50.764038353992966,31.978031180411506
walking,91939,91984,45,97.87382095136981,30.52647563440568
rising,91985,92016,31,35.38212739160554,38.493479733177445
rearing,92017,92055,38,23.256754580183667,42.27346926751871
grooming,92056,92137,81,20.20855277093348,35.88386188683414
sniffing,92138,92205,67,57.836522053223,33.29377647780794
left_turning,92206,92235,29,116.54500623120808,31.606511099118176
walking,92236,92331,95,140.9213008704029,27.67461078936401
grooming,92332,92365,33,31.58078384558732,32.74230113408223
climbing,92366,92388,22,57.08997285497626,48.65482925151604
hunching,92389,92430,41,38.692726704688965,34.040640350323464
sniffing,92431,92482,51,48.23732463746405,25.771235052936486
walking,92483,92578,95,137.16624314636297,30.34412486439966
sniffing,92579,92618,39,45.0081333773879,27.45949750483657
rearing,92619,92645,26,23.437497382574673,35.18172154617664
sniffing,92646,92693,47,61.769142188090676,29.024545822441098
left_turning,92694,92725,31,98.92530936976273,32.21375913457786
rising,92726,92774,48,50.910396880643376,33.7014314523371
climbing,92775,92802,27,56.009528523880626,49.65240254272767
walking,92803,92834,31,107.98290509519896,33.60395025922084
rising,92835,92881,46,41.51543540630918,35.62900060955379
rearing,92882,92936,54,16.32283217856469,36.40366099767067
rising,92937,92937,0,29.843537696820743,31.200962698733093
sniffing,92938,92952,14,42.45037358459743,30.503347257521334
rising,92953,93003,50,48.29816519757357,34.20824637137418
climbing,93004,93042,38,63.292366033797784,49.47039903242385
walking,93043,93060,17,92.41526613399027,32.582294697513525
trotting,93061,93062,1,253.1052987007874,31.765639178356647
walking,93063,93084,21,185.44649375473568,30.458820764057815
rising,93085,93101,16,60.91193132581328,34.01645884338515
walking,93102,93142,40,147.41315258876415,29.7089347686366
climbing,93143,93177,34,58.79711737616852,41.33268991181912
sniffing,93178,93196,18,59.64792028081322,34.90770142963913
walking,93197,93220,23,192.5559330268612,32.162987588252946
rising,93221,93246,25,79.80204422893536,35.092901851233925
climbing,93247,93292,45,41.31245360617395,41.04414727410996
sniffing,93293,93333,40,41.37112735455347,31.488478783981027
walking,93334,93372,38,161.2233534532706,28.36631083969317
rising,93373,93424,51,48.27766495402416,36.48166067818073
climbing,93425,93466,41,57.49756417042404,54.4952417917098
hunching,93467,93495,28,67.46191479419832,36.170521501561105
walking,93496,93551,55,131.52854332301152,28.92865867432897
sniffing,93552,93598,46,86.35607982931137,30.177310916372097
left_turning,93599,93657,58,78.33132662444422,28.245938701724306
rising,93658,93669,11,36.73488133229592,35.64837531797857
climbing,93670,93732,62,52.122567716705674,47.08265296055192
walking,93733,93779,46,134.39516875388372,24.304619188904816
rising,93780,93794,14,41.69157169759157,33.396570075937035
climbing,93795,93837,42,45.12815520230051,39.377407072701686
left_turning,93838,93866,28,45.528130676329745,26.053925162349536
sniffing,93867,93898,31,27.767099314088036,24.354958205067415
rising,93899,93914,15,33.21558980368786,28.7032780314171
climbing,93915,93962,47,45.741312915780576,36.81780062927373
walking,93963,94003,40,126.19287601218306,25.70385286710516
rising,94004,94089,85,26.800798252614616,29.349204062484084
climbing,94090,94120,30,51.34478987207942,38.04031424526193
sniffing,94121,94250,129,21.092079660108542,26.86488701236612
stepping,94251,94361,110,76.66862593158547,28.186110126020264
sniffing,94362,94382,20,47.64502594320057,30.537600343011675
walking,94383,94418,35,123.38169047618895,28.49836619812099
sniffing,94419,94554,135,63.19774272767157,29.584769766250847
stepping,94555,94606,51,65.74511266437281,30.2235377325873
right_turning,94607,94647,40,79.05087757349482,29.65882971615746
sniffing,94648,94703,55,33.510129102973586,30.41244855768557
walking,94704,94757,53,91.24099856647356,30.485085679708824
sniffing,94758,94836,78,61.60060373059367,27.947974278966583
rearing,94837,94873,36,52.63372505270948,37.82018835313122
sniffing,94874,95037,163,42.35460322725234,25.02273818006555
walking,95038,95091,53,143.2066332055077,29.30380150246292
left_turning,95092,95147,55,75.16453696467806,30.026650819164335
stepping,95148,95201,53,60.81960768558489,29.085702354844237
sniffing,95202,95297,95,57.72075336712904,27.51998609386541
left_turning,95298,95317,19,107.11966481580501,29.394161863702827
walking,95318,95395,77,145.8555451443157,31.659068776435824
rising,95396,95427,31,27.9866540954773,35.697383917051354
climbing,95428,95487,59,14.57901138323757,43.3535691283474
hunching,95488,95542,54,31.688098240064498,36.89516480515436
rising,95543,95565,22,57.82607200081464,34.02204502466272
rearing,95566,95603,37,21.01497388977772,35.501241055880016
sniffing,95604,95836,232,30.971508838884695,30.438529837646406
left_turning,95837,95866,29,72.40777708881541,30.37177828625063
sniffing,95867,95970,103,21.858816865913774,29.28314418668331
left_turning,95971,95991,20,54.097768948900345,28.864487351220266
stepping,95992,96047,55,56.21312041012454,32.2838752262204
walking,96048,96103,55,61.12643252586126,30.186542597748808
sniffing,96104,96192,88,36.598216387225584,30.280971082805895
rising,96193,96211,18,77.91507365367278,29.303058237960357
sniffing,96212,96267,55,50.81729305514601,28.780888791211634
stepping,96268,96319,51,74.10413132853157,30.802375202846292
walking,96320,96377,57,76.37134771441576,30.183293228161396
left_turning,96378,96392,14,95.8002398902731,30.544509358370995
walking,96393,96441,48,122.53523164354925,27.900089390040407
stepping,96442,96527,85,65.73866531121793,27.10190901135907
right_turning,96528,96571,43,82.8385665165984,29.352138922792633
stepping,96572,96627,55,65.27983753173928,26.707848908185355
right_turning,96628,96642,14,126.05742928100568,24.666590807120844
sniffing,96643,96693,50,37.25812003888325,25.980577007568492
rising,96694,96720,26,24.118476633842274,32.87757779492183
rearing,96721,96751,30,46.71624886675722,36.715017494365384
left_turning,96752,96846,94,93.99622630479399,31.170223282024686
walking,96847,96896,49,186.9071834810514,30.09890470775487
rising,96897,96944,47,39.72484580763355,28.053049628612797
hunching,96945,96986,41,42.67583388110469,34.09830619571835
sniffing,96987,97037,50,72.01590302441434,29.444965261464066
left_turning,97038,97112,74,111.69484528467046,31.119586928763415
sniffing,97113,97208,95,33.060937227889504,33.54226604972839
walking,97209,97257,48,80.42200553053164,32.34572324565016
left_turning,97258,97313,55,106.0427123524422,29.62129894876398
sniffing,97314,97352,38,27.83262301082511,29.217076408964033
walking,97353,97404,51,91.26306024863052,29.470949667613766
stepping,97405,97447,42,40.143961396507216,30.06992846545037
sniffing,97448,97548,100,41.444357488619005,27.60685327028974
rearing,97549,97554,5,42.179877067056616,37.755007610886516
climbing,97555,97593,38,52.31836565914903,44.03922941020325
sniffing,97594,97650,56,30.0647703486976,31.50308876279626
pausing,97651,97801,150,15.03984618057976,29.46802311240241
sniffing,97802,97862,60,19.822632055967855,32.38396087588579
rising,97863,97884,21,25.384216647993465,33.61509512435911
grooming,97885,97901,16,17.02229660024823,33.90079717119834
sniffing,97902,98152,250,30.405016560225004,30.737538340400594
grooming,98153,98212,59,22.421463217920795,31.844802246204075
sniffing,98213,98655,442,25.274332840037623,32.38400191757454
grooming,98656,98701,45,44.376023112828285,29.045233304088345
sniffing,98702,98780,78,40.03176702963286,30.38885507860486
grooming,98781,98855,74,16.829126944222754,36.48924604185078
sniffing,98856,98929,73,17.190887119722163,35.55312817841977
rising,98930,98964,34,21.21767902317954,37.5325414037052
sniffing,98965,99012,47,20.82132625094523,35.30786945493957
grooming,99013,99674,661,18.42720641823631,32.200822133892316
sniffing,99675,99842,167,19.434912020007356,33.29180370735616
grooming,99843,99884,41,23.442833280806433,29.314173523839653
sniffing,99885,99933,48,20.739856421736615,32.52613828376467
pausing,99934,99971,37,23.13472812516407,32.0290594542485
sniffing,99972,99982,10,28.786997498720737,34.81673030735075
grooming,99983,100017,34,25.94704317842071,33.429742101118904
hunching,100018,100077,59,19.719542410206998,38.913348271615675
rising,100078,100139,61,20.5526152489544,39.03873232151727
sniffing,100140,100143,3,22.44425050915268,37.96917648404388
pausing,100144,100217,73,18.977308415810842,35.06288880998925
sniffing,100218,100355,137,20.363313244757293,37.03610358986766
right_turning,100356,100356,0,21.429984266840822,36.04758261327817
grooming,100357,100455,98,17.58687184256526,33.60422459013337
rising,100456,100482,26,21.22819641010597,37.37339841181057
left_turning,100483,100556,73,90.53250138443683,30.62405716842574
sniffing,100557,100699,142,23.26608736385458,30.194878636996698
grooming,100700,100759,59,18.711423181494077,30.77236827823941
sniffing,100760,100809,49,38.74747765893892,31.770271386891167
rising,100810,100852,42,19.18981209647151,31.878088727481824
sniffing,100853,100864,11,27.06869828152394,31.92097878299236
grooming,100865,100907,42,19.85952458340238,32.3532977927172
sniffing,100908,100944,36,27.053670502689315,30.485843165637824
grooming,100945,101299,354,16.759110861879684,35.297786552235344
hunching,101300,101354,54,12.444382444728953,34.37740876363106
grooming,101355,101414,59,13.758942078369902,35.45009803192579
hunching,101415,101474,59,17.475116832262774,34.901268239423885
grooming,101475,101534,59,22.620963073738753,32.169450481661585
sniffing,101535,101641,106,20.86422982492786,32.34886817694024
grooming,101642,101756,114,19.301164046626013,29.760306888551835
sniffing,101757,102048,291,22.81252894018897,30.727202201652688
grooming,102049,102102,53,20.779425595015,31.81827039554907
sniffing,102103,102187,84,13.482284569571792,31.39735979182156
rearing,102188,102232,44,22.797701053447216,34.45554224089828
rising,102233,102253,20,22.49870643470992,35.3343194728939
sniffing,102254,102280,26,37.515759622202594,32.554368553140385
rising,102281,102329,48,34.54665967874293,33.35201321143628
grooming,102330,102354,24,21.796250891779263,35.024152102230495
sniffing,102355,102404,49,22.06599858696166,28.54658429291393
rising,102405,102453,48,53.64755688761213,28.76893392058708
sniffing,102454,102659,205,33.63095982540939,29.295305628010222
left_turning,102660,102670,10,101.69557982241659,34.53832242825432
trotting,102671,102680,9,182.969054390689,35.04721743611128
walking,102681,102715,34,82.16202254630655,33.35085837811428
trotting,102716,102766,50,244.91679763985317,31.294840676485528
sniffing,102767,102820,53,53.77009314613411,26.431109110738046
rising,102821,102831,10,23.36693111842351,30.638685851186416
sniffing,102832,102964,132,29.73489864046013,32.35975426901073
rising,102965,102985,20,40.84718670431443,35.58680250918529
sniffing,102986,103017,31,50.04566692450317,36.343995953395904
left_turning,103018,103072,54,108.69585535196333,35.94589370076469
walking,103073,103126,53,127.66404239576462,32.41622442650199
sniffing,103127,103146,19,41.632771506752064,29.702244912668164
rising,103147,103196,49,48.55481897197027,31.15288561862244
climbing,103197,103220,23,44.92875891839238,49.1797996880712
hunching,103221,103251,30,33.52000901548414,37.251421207566516
rising,103252,103298,46,34.59521083488236,31.449920177226595
stepping,103299,103307,8,72.87098944410046,30.028984229159455
walking,103308,103365,57,104.09354405457738,29.572490257944928
sniffing,103366,103409,43,32.4292155396969,29.781551871353727
trotting,103410,103450,40,237.070349401341,29.494157553610087
sniffing,103451,103503,52,49.62149495448168,22.82317200798235
rearing,103504,103509,5,43.55969671532418,31.622164977726396
climbing,103510,103570,60,49.92736309019041,49.15217635497433
hunching,103571,103625,54,40.395517185661646,32.119572968377
rising,103626,103674,48,82.61199667338231,30.70613083778313
walking,103675,103693,18,182.3658121603558,29.336176363511157
rearing,103694,103711,17,50.26664058267139,34.15084340747463
grooming,103712,103726,14,34.12274503418392,34.40403387157096
climbing,103727,103754,27,62.75850329204699,40.84940587792592
walking,103755,103816,61,116.6116397853984,30.52307051950854
rising,103817,103837,20,45.4547240022416,32.96023736806643
climbing,103838,103885,47,56.41326490131774,49.10030688980246
hunching,103886,103920,34,45.956974164009566,33.77957709358823
trotting,103921,103970,49,222.25456776190708,27.634583758951752
sniffing,103971,104140,169,31.66354803668254,30.323266900572527
hunching,104141,104187,46,30.4217141150103,34.50871813839803
left_turning,104188,104228,40,86.35963977277419,33.24153843621043
sniffing,104229,104302,73,70.13245194435655,30.956385645847217
walking,104303,104353,50,174.40664838852302,27.02355990454228
rising,104354,104404,50,46.31633885495997,32.51252256961703
right_turning,104405,104422,17,102.43412665159349,26.009426755275804
sniffing,104423,104728,305,65.10189696154995,26.90583552368946
rising,104729,104752,23,21.935228908599324,30.579632349232828
climbing,104753,104849,96,39.476931742609175,49.39889958162286
right_turning,104850,104874,24,88.27077495176938,33.78085205445135
walking,104875,104906,31,97.61113636013634,33.97751487841654
rising,104907,104943,36,62.49654261627469,31.51254094901818
grooming,104944,105001,57,27.210102941989902,31.10681834070315
climbing,105002,105033,31,54.216249183051914,45.14541063397404
grooming,105034,105056,22,30.28293550336039,30.86171456490615
sniffing,105057,105179,122,21.81220561834194,28.893011913693005
right_turning,105180,105211,31,89.64585026578595,27.2920268845212
sniffing,105212,105285,73,45.10301151194917,24.598469932192483
rising,105286,105298,12,38.85243094890851,29.181422439127466
grooming,105299,105337,38,35.2912733431819,31.23603128091806
sniffing,105338,105347,9,63.28372973206954,34.241644669338164
rising,105348,105365,17,44.980809536346726,34.115715124610794
left_turning,105366,105468,102,83.46771018099926,29.559506463087413
sniffing,105469,105550,81,34.33791243443871,29.33898693061869
stepping,105551,105602,51,56.27394325574993,28.665702482881038
sniffing,105603,105631,28,55.27308288017576,26.829210997982837
rising,105632,105647,15,37.53791835961675,32.85064797886088
climbing,105648,105731,83,38.92178221341658,42.00982137803228
rising,105732,105778,46,30.429618272191643,36.229512857048036
climbing,105779,105828,49,53.14107098862246,44.86262399303769
rising,105829,105833,4,113.6884708117866,33.497217366235205
walking,105834,105881,47,200.72728794255124,31.457884957694475
sniffing,105882,105939,57,21.568675190669104,28.33796832806762
left_turning,105940,105969,29,104.19426707790913,28.031157124689834
rising,105970,106018,48,29.14715336937241,35.34737998691812
climbing,106019,106071,52,19.61321005442148,37.83577774191591
rising,106072,106128,56,26.919029303762496,30.305764901555868
climbing,106129,106179,50,45.34796805937548,52.969331403277465
hunching,106180,106231,51,21.05800979086041,35.92378865539307
sniffing,106232,106291,59,18.43791199967562,28.24509355579848
rising,106292,106344,52,17.26300471264733,29.430870131591686
climbing,106345,106368,23,62.501733204584696,49.10248949230734
rearing,106369,106393,24,33.86790049962408,35.313855629302914
sniffing,106394,106470,76,37.07291981551336,29.353946798080635
grooming,106471,106569,98,24.4175419010635,35.9755018516034
sniffing,106570,106668,98,42.96300568788948,33.79779630190948
walking,106669,106728,59,164.38127280292824,32.633136049036594
sniffing,106729,106752,23,60.1490459472926,28.13217226079072
walking,106753,106802,49,154.45022601656046,26.207093932850498
rising,106803,106843,40,39.55583905160417,22.336109232182555
climbing,106844,106894,50,52.42789845613331,41.27301065412957
right_turning,106895,106900,5,148.15654761196902,27.77258847843211
walking,106901,106982,81,150.5545819282112,29.9594452293283
sniffing,106983,107022,39,29.06631176789542,29.1653580892009
rising,107023,107078,55,39.38251643844541,26.798628156987178
climbing,107079,107135,56,12.226789292190114,33.43063817835023
grooming,107136,107262,126,13.128904838230767,33.626401180756176
rearing,107263,107294,31,18.212167286665185,33.681793801019104
sniffing,107295,107339,44,38.81519136435975,32.819107369662206
grooming,107340,107384,44,24.422232488070797,34.534861269979544
left_turning,107385,107424,39,88.06280184620215,33.57825151591717
sniffing,107425,107510,85,30.98302416749048,33.28823630821936
grooming,107511,107550,39,12.497626041607338,33.449071144372304
sniffing,107551,107584,33,11.404440995860726,34.417701722084075
grooming,107585,107604,19,10.805809011298686,33.34048247522584
sniffing,107605,107953,348,21.90699138533335,32.65434103407013
rising,107954,107998,44,34.53438566802772,33.79528111265697
